no,구,구분,읍면동명,투표구명,투표소,주소,선거인수,투표수,PYS,OSH,SJH,HKY,OTY,LSB,BYK,KJA,SMS,JDH,LDY,SJY,계,무효,기권수
1,Jongno,투표소,CHWHJ,청운효자동제1투,"청운초등학교(2층, 체육관)",서울특별시 종로구 자하문로 105(청운동),2428,1187,404,732,9,10,3,3,0,7,4,0,0,3,1175,12,1241
2,Jongno,투표소,CHWHJ,청운효자동제2투,"서울농학교(1층, 대강당)",서울특별시 종로구 필운대로 103(신교동),2408,1157,440,661,6,15,4,3,0,8,1,0,0,13,1151,6,1251
3,Jongno,투표소,CHWHJ,청운효자동제3투,"청운효자동 자치회관(1층, 회의실)",서울특별시 종로구 자하문로19길 36(옥인동),2503,1274,554,638,12,19,0,4,0,13,9,0,0,17,1266,8,1229
4,Jongno,투표소,SJ,사직동제1투,"서울생활문화지원센터 체부(1층, 체부홀)",서울특별시 종로구 자하문로1나길 3-2(체부동),2305,919,354,530,8,6,3,0,0,2,3,0,0,10,916,3,1386
5,Jongno,투표소,SJ,사직동제2투,광화문스페이스본 101동 북카페(1층),"서울특별시 종로구 사직로8길 4(사직동, 광화문풍림스페이스본)",4191,2267,527,1666,10,13,8,4,0,14,3,0,1,14,2260,7,1924
6,Jongno,투표소,SCH,삼청동투표소,"삼청동주민센터(1층, 민원실)",서울특별시 종로구 삼청로 107(삼청동),1647,777,235,510,8,9,2,0,0,6,1,0,0,2,773,4,870
7,Jongno,투표소,BA,부암동제1투,"자하문셀프주유소(1층, 커피익스프레스)",서울특별시 종로구 자하문로 248(부암동),2468,1167,451,652,9,19,5,0,0,4,3,0,1,10,1154,13,1301
8,Jongno,투표소,BA,부암동제2투,"세검정초등학교(1층, 체육관)",서울특별시 종로구 세검정로9길 1(신영동),2204,1171,489,644,8,9,1,2,0,5,2,1,0,6,1167,4,1033
9,Jongno,투표소,BA,부암동제3투,"상명대학교사범대학부속초등학교(1층, 도서실)",서울특별시 종로구 홍지문2길 1(홍지동),1773,896,294,572,3,11,0,2,1,2,3,0,0,4,892,4,877
10,Jongno,투표소,PCH,평창동제1투,"평창동주민센터(지하1층, 대강당)",서울특별시 종로구 평창문화로 65(평창동),2521,1158,360,759,8,12,2,1,0,4,2,0,0,6,1154,4,1363
11,Jongno,투표소,PCH,평창동제2투,"금보성아트센터(1층, 전시장)",서울특별시 종로구 평창36길 20(평창동),3460,1732,371,1315,4,9,4,2,0,10,1,2,0,8,1726,6,1728
12,Jongno,투표소,PCH,평창동제3투,"하비에르국제학교(1층, 체육관)",서울특별시 종로구 비봉길 23(구기동),1992,1165,333,774,9,15,2,0,0,9,3,0,0,10,1155,10,827
13,Jongno,투표소,PCH,평창동제4투,"렉스펠리스아파트(1층, 주차장)","서울특별시 종로구 진흥로22나길 18(구기동, 렉스팰리스)",1970,1110,409,654,5,14,2,1,1,5,5,1,0,8,1105,5,860
14,Jongno,투표소,PCH,평창동제5투,"종로치매지원센터(3층, 강당)",서울특별시 종로구 평창문화로 50(평창동),1959,986,264,686,6,11,2,5,0,4,0,1,1,4,984,2,973
15,Jongno,투표소,MA,무악동제1투,"종로노인종합복지관 무악센터(5층, 강당)",서울특별시 종로구 통일로14길 30(무악동),1930,1044,335,664,5,9,1,2,0,13,1,2,0,7,1039,5,886
16,Jongno,투표소,MA,무악동제2투,"무악동주민센터(4층, 강당)",서울특별시 종로구 통일로14길 36(무악동),2759,1391,479,857,4,13,3,6,0,10,2,1,0,9,1384,7,1368
17,Jongno,투표소,KN,교남동제1투,"교남동주민센터(4층, 강당)",서울특별시 종로구 송월길 154(행촌동),1789,766,335,388,5,12,1,2,0,5,3,1,1,4,757,9,1023
18,Jongno,투표소,KN,교남동제2투,"교남동주민센터(2층, 취미교실B)",서울특별시 종로구 송월길 154(행촌동),1635,772,293,439,6,7,5,3,0,3,0,0,1,2,759,13,863
19,Jongno,투표소,KN,교남동제3투,"경희궁자이2단지아파트 주민공동시설(지하1층, 207동)","서울특별시 종로구 송월길 99(홍파동과 송월동 경계선,경희궁자이 2단지)",2878,1780,440,1273,5,18,3,5,0,14,3,0,3,7,1771,9,1098
20,Jongno,투표소,KH,가회동투표소,"가회동주민센터(지하1층, 대강당)",서울특별시 종로구 북촌로 35(가회동),2681,1275,471,748,4,13,5,2,0,11,6,0,0,8,1268,7,1406
21,Jongno,투표소,JR1·2·3·4,종로1·2·3·4가동제1투,"교동초등학교(1층, 현관로비)",서울특별시 종로구 삼일대로 446(경운동),2587,877,291,547,1,21,4,1,0,2,0,0,0,5,872,5,1710
22,Jongno,투표소,JR1·2·3·4,종로1·2·3·4가동제2투,종로1234가동주민센터(3층 강당),서울특별시 종로구 삼일대로30길 47(익선동),3069,1308,488,773,10,12,3,2,0,7,1,1,1,2,1300,8,1761
23,Jongno,투표소,JR5·6,종로5·6가동제1투,"효제초등학교(1층, 체육관)",서울특별시 종로구 대학로 12(효제동),2091,821,252,532,6,8,0,3,0,5,3,0,0,6,815,6,1270
24,Jongno,투표소,JR5·6,종로5·6가동제2투,"종로5.6가동주민센터(4층, 강당)",서울특별시 종로구 종로35가길 19(효제동),1818,736,307,396,1,12,1,1,0,7,2,1,0,4,732,4,1082
25,Jongno,투표소,EH,이화동제1투,"좋은공연안내센터(1층, 로비)",서울특별시 종로구 대학로 104(동숭동),2643,1241,525,640,13,19,6,4,0,8,6,0,0,3,1224,17,1402
26,Jongno,투표소,EH,이화동제2투,"이화동주민센터(4층, 다목적실)",서울특별시 종로구 이화장길 33(이화동),2548,1081,380,636,8,18,3,6,0,6,4,0,0,5,1066,15,1467
27,Jongno,투표소,HHW,혜화동제1투,"올림픽기념국민생활관(1층, 로비)",서울특별시 종로구 성균관로 91(혜화동),2643,1313,503,726,17,14,4,1,0,17,2,2,2,5,1293,20,1330
28,Jongno,투표소,HHW,혜화동제2투,"혜화동주민센터(2층, 혜화홀)",서울특별시 종로구 혜화로 12(혜화동),2670,1147,368,698,13,18,4,6,0,11,7,0,0,10,1135,12,1523
29,Jongno,투표소,HHW,혜화동제3투,"동성고등학교 동성100주년기념관(1층, 혜화아트센터)",서울특별시 종로구 대학로 156(혜화동),2394,1128,348,721,11,11,5,2,0,10,4,1,0,6,1119,9,1266
30,Jongno,투표소,HHW,혜화동제4투,"종로구 육아종합지원센터(4층, 다목적교육실)",서울특별시 종로구 성균관로1길 6-3(명륜3가),1919,845,301,472,20,14,1,4,0,12,1,0,1,7,833,12,1074
31,Jongno,투표소,HHW,혜화동제5투,"명륜동와룡문화센터(4층,와룡스포츠센터)",서울특별시 종로구 명륜길 26(명륜3가),1581,700,277,373,7,8,2,4,0,9,1,1,0,7,689,11,881
32,Jongno,투표소,CHS1,창신제1동제1투,"창신1동주민센터(1층, 민원실)",서울특별시 종로구 지봉로 8-6(창신동),1188,382,166,206,0,2,2,2,0,0,1,0,0,0,379,3,806
33,Jongno,투표소,CHS1,창신제1동제2투,"종로구민회관(1층, 로비)",서울특별시 종로구 지봉로5길 7-5(창신동),2567,1164,498,626,13,14,2,1,0,3,0,0,1,1,1159,5,1403
34,Jongno,투표소,CHS2,창신제2동제1투,"동부여성문화센터(1층, 체조실)",서울특별시 종로구 창신길 124(창신동),1673,570,238,319,2,4,0,0,0,0,2,0,0,2,567,3,1103
35,Jongno,투표소,CHS2,창신제2동제2투,"창신2동 마을회관(1층, 다목적실)",서울특별시 종로구 낙산성곽1길 37(창신동),2346,1026,472,521,5,10,1,2,1,1,1,0,0,2,1016,10,1320
36,Jongno,투표소,CHS2,창신제2동제3투,"동부여성문화센터(2층, 사무실)",서울특별시 종로구 창신길 124(창신동),2157,897,408,453,2,9,1,3,0,5,1,0,0,2,884,13,1260
37,Jongno,투표소,CHS3,창신제3동제1투,"창신3동주민센터(3층, 다목적실)","서울특별시 종로구 지봉로 87(창신동,창신3동주민센터)",1595,660,300,327,4,7,3,2,0,5,1,0,1,1,651,9,935
38,Jongno,투표소,CHS3,창신제3동제2투,창신쌍용2단지아파트 경로당(1층),"서울특별시 종로구 낙산길 198(창신동, 창신쌍용아파트 2지구) 경로당",2756,1368,509,799,8,19,0,6,0,10,3,0,1,7,1362,6,1388
39,Jongno,투표소,SI1,숭인제1동제1투,"숭인1동주민센터(1층, 다목적실)",서울특별시 종로구 지봉로 86(숭인동),2314,871,340,499,3,5,2,4,0,4,0,1,0,6,864,7,1443
40,Jongno,투표소,SI1,숭인제1동제2투,"숭인1동주민센터(5층, 대강당)",서울특별시 종로구 지봉로 86(숭인동),1776,773,323,424,6,7,1,2,1,2,0,0,0,3,769,4,1003
41,Jongno,투표소,SI2,숭인제2동제1투,"한국마사회 종로지사(1층, 로비)",서울특별시 종로구 난계로29길 49(숭인동),2784,1010,388,542,10,18,6,3,0,22,6,0,0,5,1000,10,1774
42,Jongno,투표소,SI2,숭인제2동제2투,"숭인2동주민센터(4층, 강당)",서울특별시 종로구 종로65길 10(숭인동),2194,872,351,490,5,12,1,0,0,6,1,0,0,1,867,5,1322
43,Jongno,투표소,SI2,숭인제2동제3투,"서울직업전문학교 본관(1층, 로비)",서울특별시 종로구 종로 375(숭인동),2209,876,421,419,5,7,1,3,1,7,0,0,1,0,865,11,1333
44,Jung,투표소,SK,소공동제1투,"소공동주민센터(4층, 강당)",서울특별시 중구 남대문로1길 31-5(북창동),420,136,40,92,0,3,0,0,0,0,0,0,0,0,135,1,284
45,Jung,투표소,SK,소공동제2투,"창덕여자중학교(1층, 대강당)",서울특별시 중구 정동길 22(정동),1016,509,165,312,4,7,1,2,0,7,2,0,0,6,506,3,507
46,Jung,투표소,HH,회현동제1투,"회현동주민센터(3층, 강당)",서울특별시 중구 퇴계로8길 46(회현동1가),3111,1161,344,781,6,13,0,2,0,3,1,1,0,3,1154,7,1950
47,Jung,투표소,HH,회현동제2투,남대문5가경로당(1층),서울특별시 중구 후암로60길 23(남대문로5가),750,329,128,193,2,3,0,0,1,1,0,0,0,1,329,0,421
48,Jung,투표소,M,명동제1투,"명동주민센터(3층, 강당)",서울특별시 중구 퇴계로20길 3(남산동2가),1907,727,235,466,2,9,2,2,0,3,0,0,0,5,724,3,1180
49,Jung,투표소,M,명동제2투,"중구문화원(1층, 전시실)",서울특별시 중구 청계천로 86(장교동),149,40,13,26,0,0,1,0,0,0,0,0,0,0,40,0,109
50,Jung,투표소,P,필동제1투,"필동주민센터(2층, 강당)",서울특별시 중구 퇴계로36길 42(필동2가),1396,573,208,329,5,11,3,1,0,5,1,1,0,2,566,7,823
51,Jung,투표소,P,필동제2투,필동경로당(1층),서울특별시 중구 필동로 11(필동2가),1452,671,215,421,1,10,2,4,0,5,2,0,0,5,665,6,781
52,Jung,투표소,JCH,장충동제1투,"장충동주민센터(5층, 대강당)",서울특별시 중구 장충단로8길 22(장충동1가),1734,725,236,447,6,6,3,2,0,8,3,0,0,1,712,13,1009
53,Jung,투표소,JCH,장충동제2투,"충무초등학교(3층, 대강당)",서울특별시 중구 퇴계로50길 13(장충동2가),1635,697,278,375,8,8,1,4,0,6,5,0,0,3,688,9,938
54,Jung,투표소,KH,광희동제1투,"광희동주민센터(5층, 대강당)",서울특별시 중구 퇴계로 303-9(광희동1가),1875,649,225,394,4,9,1,1,0,3,1,2,1,1,642,7,1226
55,Jung,투표소,KH,광희동제2투,"덕수중학교(1층, 진로진학상담실)",서울특별시 중구 마른내로9길 10(인현동2가),2273,1079,306,729,4,6,3,1,0,15,3,1,1,4,1073,6,1194
56,Jung,투표소,EJR,을지로동제1투,"을지로동주민센터(4층, 강당)",서울특별시 중구 충무로9길 19(을지로3가),794,261,84,167,0,3,1,0,0,3,0,0,0,1,259,2,533
57,Jung,투표소,EJR,을지로동제2투,"을지경로당(1층, 다용도공간)",서울특별시 중구 을지로28길 16(을지로4가),619,306,107,190,1,4,0,1,0,0,0,0,0,1,304,2,313
58,Jung,투표소,SD,신당동제1투,"신당누리센터(5층, 배움누리방2)",서울특별시 중구 다산로33길 3(신당동),2139,773,304,431,5,11,2,2,0,2,5,0,0,3,765,8,1366
59,Jung,투표소,SD,신당동제2투,"광희초등학교(1층, 연수운영실)",서울특별시 중구 다산로 269(신당동),1842,793,237,523,5,6,0,1,0,10,3,0,0,3,788,5,1049
60,Jung,투표소,SD,신당동제3투,신일경로당(1층),서울특별시 중구 청구로 121(신당동),1944,841,329,477,4,7,1,2,0,5,4,1,1,2,833,8,1103
61,Jung,투표소,DS,다산동제1투,"다산동주민센터(1층, 대강당)",서울특별시 중구 동호로15길 50(신당동),2661,1102,418,629,6,13,3,2,0,12,2,0,2,6,1093,9,1559
62,Jung,투표소,DS,다산동제2투,"장충초등학교 별관동 소강당(1층, 소체육실)",서울특별시 중구 청구로17길 40(신당동),2681,1235,441,727,8,18,4,3,0,6,1,1,2,7,1218,17,1446
63,Jung,투표소,DS,다산동제3투,"장충고등학교 화승관(1층, 도서관)",서울특별시 중구 동호로15길 93(신당동),2254,928,377,495,5,12,2,3,0,12,2,2,0,9,919,9,1326
64,Jung,투표소,DS,다산동제4투,"장수경로당(1층, 할머니방)",서울특별시 중구 동호로11다길 18(신당동),2552,1197,451,676,5,19,3,1,0,9,7,0,1,8,1180,17,1355
65,Jung,투표소,YS,약수동제1투,"약수동주민센터(4층, 강당)",서울특별시 중구 다산로 92(신당동),1632,615,201,390,3,9,0,1,0,4,0,0,0,3,611,4,1017
66,Jung,투표소,YS,약수동제2투,"동호경로당(1층, 할아버지방)",서울특별시 중구 동호로8길 42-22(신당동),1865,923,384,506,2,7,2,3,0,5,0,2,0,5,916,7,942
67,Jung,투표소,YS,약수동제3투,"남산타운아파트 (1층, 입주자대표회의실)",서울특별시 중구 다산로 32(신당동),3054,1716,488,1182,4,11,4,2,0,8,2,0,0,6,1707,9,1338
68,Jung,투표소,YS,약수동제4투,"남산타운아파트 25동(1층, 25동 복지관)",서울특별시 중구 다산로 32(신당동),2804,1676,510,1135,6,4,1,3,0,4,0,0,0,6,1669,7,1128
69,Jung,투표소,YS,약수동제5투,"중구청소년센터(지하1층, 식당)",서울특별시 중구 동호로5길 19(신당동),2617,1237,536,654,8,21,0,2,0,6,1,0,1,2,1231,6,1380
70,Jung,투표소,CHK,청구동제1투,청구초등학교 야구부실내훈련장(1층),서울특별시 중구 다산로 170(신당동),1381,606,223,356,5,11,0,2,0,2,1,1,0,0,601,5,775
71,Jung,투표소,CHK,청구동제2투,"청구노인복지센터(지하1층, 어울림실)",서울특별시 중구 청구로3길 69(신당동),1952,705,269,389,5,11,2,1,1,7,2,0,2,8,697,8,1247
72,Jung,투표소,CHK,청구동제3투,약수유치원(1층),서울특별시 중구 동호로10길 30(신당동),2164,1431,424,957,6,9,4,7,0,13,1,0,0,1,1422,9,733
73,Jung,투표소,CHK,청구동제4투,약수하이츠경로당(1층),서울특별시 중구 동호로10길 30(신당동),1782,1055,422,589,5,14,2,3,0,5,2,1,0,5,1048,7,727
74,Jung,투표소,CHK,청구동제5투,삼성아파트경로당(1층),서울특별시 중구 청구로1길 23(신당동),2585,1474,489,939,8,8,1,4,0,4,1,0,1,7,1462,12,1111
75,Jung,투표소,SD5,신당제5동제1투,"신당제5동주민센터(3층, 강당)",서울특별시 중구 다산로44길 85(신당동),2208,784,304,442,4,8,5,0,0,4,2,0,0,5,774,10,1424
76,Jung,투표소,SD5,신당제5동제2투,"유락종합사회복지관 (1층, 로비)",서울특별시 중구 퇴계로 460(신당동),3223,1333,501,789,9,8,1,0,0,8,2,1,2,3,1324,9,1890
77,Jung,투표소,SD5,신당제5동제3투,한진해모로아파트 경로당(1층),서울특별시 중구 왕십리로39길 30(신당동),1880,793,327,427,5,10,2,3,0,7,0,0,1,3,785,8,1087
78,Jung,투표소,DH,동화동제1투,"동화동주민센터(1층, 펀펀카페)",서울특별시 중구 다산로36길 100(신당동),1282,551,183,342,3,6,1,3,0,7,1,0,0,4,550,1,731
79,Jung,투표소,DH,동화동제2투,"동화동주민센터(지하1층, 대강당)",서울특별시 중구 다산로36길 100(신당동),1827,961,321,591,2,16,1,1,0,13,2,1,1,2,951,10,866
80,Jung,투표소,DH,동화동제3투,"흥인초등학교(2층, 보건교육실)",서울특별시 중구 청구로6길 11(신당동),2125,1058,317,705,2,5,0,2,0,14,3,1,0,1,1050,8,1067
81,Jung,투표소,DH,동화동제4투,동화동 구립경로당(1층),서울특별시 중구 퇴계로80길 52(신당동),1611,697,287,376,1,9,1,2,1,8,5,0,0,1,691,6,914
82,Jung,투표소,HWH,황학동제1투,"황학동주민센터(4층, 강당)",서울특별시 중구 난계로11길 52(황학동),4025,1509,614,815,9,24,3,1,0,17,6,0,1,7,1497,12,2516
83,Jung,투표소,HWH,황학동제2투,황학어린이집옆 코사마트앞 건물(1층),서울특별시 중구 마장로15길 16(황학동),2339,876,350,480,3,19,2,4,0,7,3,0,2,3,873,3,1463
84,Jung,투표소,HWH,황학동제3투,"롯데캐슬베네치아 102동(7층, 다용도실)","서울특별시 중구 청계천로 400(황학동, 롯데캐슬베네치아)",3275,1655,606,1001,3,23,1,6,0,5,2,0,2,2,1651,4,1620
85,Jung,투표소,JR,중림동제1투,"중림동주민센터(1층, 다목적실)",서울특별시 중구 만리재로 175(만리동2가),2819,1395,424,926,3,8,5,3,0,9,1,0,0,11,1390,5,1424
86,Jung,투표소,JR,중림동제2투,"중림종합사회복지관(3층, 대강당)",서울특별시 중구 서소문로6길 16(중림동),2683,1223,513,670,6,14,1,1,0,6,2,1,0,2,1216,7,1460
87,Jung,투표소,JR,중림동제3투,"중림삼성사이버빌리지 종합지원센터(1층, 주민회의실)",서울특별시 중구 중림로 10(중림동),2632,1533,549,922,4,23,0,3,0,11,4,0,0,5,1521,12,1099
88,Yongsan,투표소,HA,후암동제1투,"후암동주민센터(3층, 대강당)",서울특별시 용산구 후암로 32-6(후암동),3499,1478,635,780,12,22,1,3,0,9,1,1,0,4,1468,10,2021
89,Yongsan,투표소,HA,후암동제2투,"후암초등학교(1층, 방과후교육실)",서울특별시 용산구 두텁바위로 140(후암동),2619,1060,433,564,7,15,4,4,0,9,2,0,0,11,1049,11,1559
90,Yongsan,투표소,HA,후암동제3투,"삼광초등학교(1층, 체육관)",서울특별시 용산구 두텁바위로1나길 19(후암동),2731,1214,452,712,4,14,2,3,0,9,3,0,0,8,1207,7,1517
91,Yongsan,투표소,HA,후암동제4투,"혜심원(지하1층, 식당)",서울특별시 용산구 소월로2나길 18(후암동),2924,1305,502,737,4,23,1,4,0,8,6,1,2,8,1296,9,1619
92,Yongsan,투표소,YS2,용산2가동제1투,"용산2가동주민센터(3층, 강당)",서울특별시 용산구 신흥로 90(용산동2가),2404,891,362,480,9,9,3,1,0,6,1,0,0,12,883,8,1513
93,Yongsan,투표소,YS2,용산2가동제2투,"용암경로당(1층, 할아버지방)",서울특별시 용산구 신흥로3가길 21-7(용산동2가),1689,702,253,403,9,6,2,3,0,9,3,0,0,8,696,6,987
94,Yongsan,투표소,YS2,용산2가동제3투,"보성여자고등학교(1층, 체육관)",서울특별시 용산구 신흥로3가길 66(용산동2가),1482,644,258,342,5,11,5,0,0,3,2,0,2,8,636,8,838
95,Yongsan,투표소,YS2,용산2가동제4투,"용산고등학교(1층, 강당)",서울특별시 용산구 두텁바위로 60(용산동2가),1651,665,279,356,3,7,1,2,0,5,1,1,0,4,659,6,986
96,Yongsan,투표소,NY,남영동제1투,"갈월종합사회복지관(2층, 취업교실)",서울특별시 용산구 두텁바위로 25(갈월동),3085,1157,495,612,8,18,2,4,0,7,1,1,1,3,1152,5,1928
97,Yongsan,투표소,NY,남영동제2투,"서울버스노조회관(1층, 로비)",서울특별시 용산구 한강대로102길 17(동자동),2844,1143,446,648,6,10,5,1,0,5,3,2,0,5,1131,12,1701
98,Yongsan,투표소,CHP,청파동제1투,"청파도서관·청파동자치회관 별관(3층, 대강당)",서울특별시 용산구 청파로93길 27(서계동),1752,753,251,470,2,10,1,1,0,4,2,1,1,4,747,6,999
99,Yongsan,투표소,CHP,청파동제2투,"청파노인복지센터(1층, 으뜸마당)",서울특별시 용산구 청파로83길 26(서계동),2041,815,359,420,3,16,1,1,1,1,2,0,0,5,809,6,1226
100,Yongsan,투표소,CHP,청파동제3투,"청파초등학교 (2층, 체육관)",서울특별시 용산구 효창원로 228(청파동2가),2436,1042,451,538,7,13,2,4,0,10,2,1,0,8,1036,6,1394
101,Yongsan,투표소,CHP,청파동제4투,"청파동주민센터(2층, 대강당)",서울특별시 용산구 청파로49길 6(청파동2가),3034,1248,498,668,7,17,2,3,0,29,4,1,0,7,1236,12,1786
102,Yongsan,투표소,CHP,청파동제5투,"선린인터넷고등학교 체육관(1층, 창의활동교육실)",서울특별시 용산구 원효로97길 33-4(청파동3가),2548,1019,349,547,21,15,6,4,0,45,4,1,1,19,1012,7,1529
103,Yongsan,투표소,CHP,청파동제6투,"청파동주민센터 (3층, 다목적실)",서울특별시 용산구 청파로49길 6(청파동2가),2599,911,324,478,15,17,1,4,0,52,6,0,1,7,905,6,1688
104,Yongsan,투표소,WHR1,원효로제1동제1투,"용산구보건분소(6층, 원효로제1동자치회관)",서울특별시 용산구 백범로 329(원효로1가),3067,1396,520,783,10,18,4,2,0,26,5,1,0,11,1380,16,1671
105,Yongsan,투표소,WHR1,원효로제1동제2투,"남정초등학교 동관(1층, 현관)",서울특별시 용산구 원효로64길 17-10(원효로2가),2625,1176,337,794,7,8,0,5,1,8,3,1,0,1,1165,11,1449
106,Yongsan,투표소,WHR1,원효로제1동제3투,"원효로제1동주민센터(용산구문화체육센터 4층, 대강당)",서울특별시 용산구 백범로 350(문배동),4913,2284,611,1600,9,13,1,1,1,24,2,0,1,5,2268,16,2629
107,Yongsan,투표소,WHR2,원효로제2동제1투,"원효로제2동주민센터(지하1층, 주차장)",서울특별시 용산구 효창원로8길 3(산천동),3902,1990,630,1283,8,14,5,4,0,16,2,1,2,8,1973,17,1912
108,Yongsan,투표소,WHR2,원효로제2동제2투,"용산문화원(3층, 대강당)",서울특별시 용산구 효창원로8길 28(원효로4가),2707,1336,424,858,4,15,3,3,0,13,2,0,1,5,1328,8,1371
109,Yongsan,투표소,WHR2,원효로제2동제3투,"성심여자중·고등학교 체육관(1층, 소피아홀)",서울특별시 용산구 원효로19길 49(원효로4가),2727,1263,496,707,10,17,1,4,0,12,4,1,0,7,1259,4,1464
110,Yongsan,투표소,HCH,효창동제1투,"효창종합사회복지관(4층, 문화체육실)",서울특별시 용산구 효창원로 146-12(효창동),3060,1449,514,851,11,23,4,1,0,15,3,1,1,10,1434,15,1611
111,Yongsan,투표소,HCH,효창동제2투,"효창동주민센터(5층, 대강당)",서울특별시 용산구 효창원로 161(효창동),2118,1012,299,667,5,6,0,2,0,11,4,0,0,9,1003,9,1106
112,Yongsan,투표소,HCH,효창동제3투,"효창동주민센터(4층, 다목적실)",서울특별시 용산구 효창원로 161(효창동),1286,629,210,389,6,5,2,1,0,7,1,0,0,3,624,5,657
113,Yongsan,투표소,YM,용문동제1투,"용문동주민센터(3층, 자치회관)",서울특별시 용산구 새창로12길 13(도원동),3126,1297,554,679,9,10,1,4,0,13,8,1,1,8,1288,9,1829
114,Yongsan,투표소,YM,용문동제2투,"용문동주민센터(4층, 대강당)",서울특별시 용산구 새창로12길 13(도원동),2425,1017,358,612,12,8,0,6,0,7,2,0,0,2,1007,10,1408
115,Yongsan,투표소,YM,용문동제3투,"도원삼성래미안아파트 제1경로당(1층, 할아버지방)","서울특별시 용산구 새창로 70(도원동, 삼성래미안아파트)",2579,1530,453,1016,9,14,1,3,0,12,2,1,0,3,1514,16,1049
116,Yongsan,투표소,HKR,한강로동제1투,"용산파크자이오피스텔(1층, 로비)","서울특별시 용산구 한강대로 205(한강로1가, 용산파크자이)",2842,1578,421,1105,6,8,2,2,0,11,5,0,0,9,1569,9,1264
117,Yongsan,투표소,HKR,한강로동제2투,"한강로동주민센터(2층,소회의실)",서울특별시 용산구 한강대로38길 28(한강로2가),3878,1733,291,1403,3,4,1,3,0,11,0,0,0,6,1722,11,2145
118,Yongsan,투표소,HKR,한강로동제3투,"용산초등학교(1층, 중앙로비)",서울특별시 용산구 한강대로57길 33(한강로2가),2461,1161,365,726,7,8,3,5,0,15,3,1,1,7,1141,20,1300
119,Yongsan,투표소,HKR,한강로동제4투,"용산철도고등학교(2층, 모둠학습실)[(구)용산공업고등학교]",서울특별시 용산구 서빙고로 24(한강로3가),3903,2176,363,1758,5,16,4,2,0,11,5,0,1,4,2169,7,1727
120,Yongsan,투표소,HKR,한강로동제5투,"한강초등학교(1층, 급식실)",서울특별시 용산구 한강대로14길 9(한강로3가),2099,908,261,617,3,11,1,1,0,5,0,1,0,5,905,3,1191
121,Yongsan,투표소,ICH1,이촌제1동제1투,"이촌제1동주민센터(4층, 소극장)",서울특별시 용산구 이촌로71길 24(이촌동),3636,2034,252,1751,1,5,2,4,0,12,0,0,1,5,2033,1,1602
122,Yongsan,투표소,ICH1,이촌제1동제2투,"이촌제1동주민센터(3층, 다목적실)",서울특별시 용산구 이촌로71길 24(이촌동),4566,2264,423,1794,3,10,5,2,0,10,3,0,1,5,2256,8,2302
123,Yongsan,투표소,ICH1,이촌제1동제3투,"중경고등학교(정보센터 2층, 소강당)",서울특별시 용산구 이촌로84길 34(이촌동),2897,1758,289,1435,6,11,3,0,0,4,0,1,0,4,1753,5,1139
124,Yongsan,투표소,ICH1,이촌제1동제4투,"용강중학교(강당동 1층, 동아리실)",서울특별시 용산구 이촌로65가길 91(이촌동),3429,1954,418,1480,5,11,5,1,0,13,2,0,1,8,1944,10,1475
125,Yongsan,투표소,ICH1,이촌제1동제5투,"신용산초등학교(1층, 과학1실)",서울특별시 용산구 이촌로 255(이촌1동),2524,1419,165,1231,2,6,1,2,0,1,1,0,0,4,1413,6,1105
126,Yongsan,투표소,ICH2,이촌제2동제1투,"이촌제2동주민센터 (3층, 대강당)",서울특별시 용산구 이촌로18길 20(이촌동),1803,852,236,583,3,15,1,1,0,2,1,1,0,3,846,6,951
127,Yongsan,투표소,ICH2,이촌제2동제2투,"이촌제2동주민센터 (지하 1층, 다목적실)",서울특별시 용산구 이촌로18길 20(이촌동),1712,947,231,686,4,13,1,2,0,3,0,0,0,0,940,7,765
128,Yongsan,투표소,ICH2,이촌제2동제3투,"동아그린아파트 103동 (지하 1층, 체력단련실)","서울특별시 용산구 이촌로 100-8(이촌동, 동아그린아파트)",2274,1381,405,950,2,7,1,3,0,4,2,0,0,4,1378,3,893
129,Yongsan,투표소,ITW1,이태원제1동제1투,청화아파트 경로당(1층),"서울특별시 용산구 장문로 27(이태원동, 청화아파트)",3372,1436,361,1031,5,10,9,1,0,7,1,1,0,6,1432,4,1936
130,Yongsan,투표소,ITW1,이태원제1동제2투,이태원남부경로당(1층),서울특별시 용산구 이태원로17길 12(이태원동),2047,849,227,592,5,6,1,4,0,2,1,0,0,2,840,9,1198
131,Yongsan,투표소,ITW2,이태원제2동제1투,"이태원제2동주민센터(3층, 대강당)",서울특별시 용산구 회나무로13길 58(이태원동),2725,1060,291,728,5,18,2,2,0,8,2,0,0,2,1058,2,1665
132,Yongsan,투표소,ITW2,이태원제2동제2투,"이태원2동 새마을금고(4층, 회의실)",서울특별시 용산구 회나무로 30(이태원동),2312,1002,320,633,3,8,5,0,1,14,2,0,1,9,996,6,1310
133,Yongsan,투표소,ITW2,이태원제2동제3투,서울이태원초등학교 교육문화관(1층),서울특별시 용산구 녹사평대로40길 19서울이태원초등학교 (이태원동),1767,763,253,465,6,8,4,1,0,14,2,0,0,9,762,1,1004
134,Yongsan,투표소,HN,한남동제1투,제천회관(1층),서울특별시 용산구 대사관로34길 49(한남동),2902,1459,372,1036,3,17,3,2,0,5,2,0,0,8,1448,11,1443
135,Yongsan,투표소,HN,한남동제2투,"한남동주민센터(지하1층, 대강당)",서울특별시 용산구 대사관로5길 1(한남동),2392,845,311,492,3,14,4,2,0,8,6,0,0,1,841,4,1547
136,Yongsan,투표소,HN,한남동제3투,"중부기술교육원(지하1층, 본관 강당)",서울특별시 용산구 한남대로 136(한남동),3866,1723,285,1411,0,7,3,0,1,3,4,0,0,2,1716,7,2143
137,Yongsan,투표소,HN,한남동제4투,"용산공예관(4층, 다목적실)",서울특별시 용산구 이태원로 274(한남동),2907,1362,304,1016,5,11,4,1,0,7,0,2,0,6,1356,6,1545
138,Yongsan,투표소,HN,한남동제5투,"한남동주민센터(3층, 자치회관)",서울특별시 용산구 대사관로5길 1(한남동),3135,904,304,554,6,16,2,2,0,6,1,0,0,6,897,7,2231
139,Yongsan,투표소,SBK,서빙고동제1투,용산푸르지오파크타운 휘트니스센터 GX룸(1층),"서울특별시 용산구 녹사평대로 66(동빙고동, 용산푸르지오파크타운)",2421,1200,285,872,6,6,2,4,0,10,1,1,0,7,1194,6,1221
140,Yongsan,투표소,SBK,서빙고동제2투,동빙고경로당(1층),서울특별시 용산구 서빙고로75가길 23(동빙고동),1954,871,274,564,2,16,1,2,0,4,0,0,0,1,864,7,1083
141,Yongsan,투표소,SBK,서빙고동제3투,신동아아파트 관리사무소 내 할아버지경로당(1층),"서울특별시 용산구 이촌로 347(서빙고동, 신동아아파트)",2776,1875,153,1684,6,4,4,1,0,7,0,0,1,4,1864,11,901
142,Yongsan,투표소,SBK,서빙고동제4투,"서빙고초등학교(1층, 체육실)",서울특별시 용산구 서빙고로51길 14(서빙고동),1438,568,140,413,2,7,0,1,0,2,0,0,0,1,566,2,870
143,Yongsan,투표소,BK,보광동제1투,"보광동주민센터(1층, 북카페)",서울특별시 용산구 장문로 95(보광동),3055,1081,365,661,5,14,5,4,0,7,1,1,0,8,1071,10,1974
144,Yongsan,투표소,BK,보광동제2투,"보광동주민센터(5층, 대강당)",서울특별시 용산구 장문로 95(보광동),2443,953,383,520,4,9,6,3,0,7,3,0,0,8,943,10,1490
145,Yongsan,투표소,BK,보광동제3투,"한국폴리텍Ⅰ대학(1층, 제3공학관 로비)",서울특별시 용산구 보광로 73(보광동),2819,1137,397,698,6,10,2,0,0,7,4,0,0,8,1132,5,1682
146,Yongsan,투표소,BK,보광동제4투,"보광동주민센터(지하1층, 주차장)",서울특별시 용산구 장문로 95(보광동),2312,912,311,567,4,8,2,1,0,5,1,0,0,7,906,6,1400
147,Seongdong,투표소,KH1,금호1가동제1투,"금호1가동주민센터(4층, 다목적실)",서울특별시 성동구 행당로 15(금호동1가),2121,834,328,460,5,15,3,2,0,6,4,0,0,3,826,8,1287
148,Seongdong,투표소,KH1,금호1가동제2투,벽산아파트 제2경로당(1층),"서울특별시 성동구 금호로 100(금호동1가, 벽산아파트)",3081,1562,568,929,9,21,0,0,1,6,4,0,1,4,1543,19,1519
149,Seongdong,투표소,KH1,금호1가동제3투,벽산아파트 제1경로당(지하1층),"서울특별시 성동구 금호로 100(금호동1가, 벽산아파트)",3318,1747,574,1132,5,9,0,0,0,12,4,0,0,5,1741,6,1571
150,Seongdong,투표소,KH1,금호1가동제4투,"금호고등학교(2층, 체육관)",서울특별시 성동구 금호로 118(금호동1가),2108,1007,269,712,3,7,1,1,0,4,2,1,0,3,1003,4,1101
151,Seongdong,투표소,KH2·3,금호2·3가동제1투,"금호2·3가동주민센터(3층, 다목적방)",서울특별시 성동구 무수막18길 1(금호동2가),3806,1730,616,1056,5,19,4,5,0,9,1,2,0,6,1723,7,2076
152,Seongdong,투표소,KH2·3,금호2·3가동제2투,"성동청소년문화의집(1층, 식당)",서울특별시 성동구 장터1길 18(금호동3가),3338,1431,553,833,5,11,0,0,1,14,1,1,0,4,1423,8,1907
153,Seongdong,투표소,KH2·3,금호2·3가동제3투,"금호자이아파트 지하주차장내 AS센터(지하1층, 자이안라운지)","서울특별시 성동구 금호산8길 14(금호동3가, 금호자이2차)",3376,1460,516,886,8,18,2,6,0,13,1,0,0,1,1451,9,1916
154,Seongdong,투표소,KH2·3,금호2·3가동제4투,두산아파트 경로당(1층),"서울특별시 성동구 동호로 100(금호동3가, 두산아파트)",2478,1477,464,967,6,10,2,4,0,6,1,2,0,2,1464,13,1001
155,Seongdong,투표소,KH2·3,금호2·3가동제5투,금호자이1차아파트 생활지원센터 내 멀티룸(1층),"서울특별시 성동구 금호로 117(금호동2가, 금호자이1차)",2922,1263,415,820,2,11,0,4,0,2,1,1,1,2,1259,4,1659
156,Seongdong,투표소,KH4,금호4가동제1투,"금호4가동주민센터(4층, 다목적실)",서울특별시 성동구 독서당로46길 26(금호동4가),1899,770,215,532,3,6,1,2,0,4,1,2,1,0,767,3,1129
157,Seongdong,투표소,KH4,금호4가동제2투,대우아파트 경로당(1층),"서울특별시 성동구 독서당로 272(금호동4가, 금호동 대우아파트)",2691,1446,496,917,8,8,1,1,0,5,2,1,0,0,1439,7,1245
158,Seongdong,투표소,KH4,금호4가동제3투,"금옥초등학교(1층, 실과실)",서울특별시 성동구 독서당로 251(금호동4가),2569,1103,394,665,5,18,2,2,0,3,2,0,0,5,1096,7,1466
159,Seongdong,투표소,KH4,금호4가동제4투,"독서당인문아카데미센터(1층, 로비)",서울특별시 성동구 금호로 30(금호동4가),2380,1295,358,909,5,5,3,4,0,4,1,1,1,2,1293,2,1085
160,Seongdong,투표소,OS,옥수동제1투,"래미안옥수리버젠아파트커뮤니티센터(지하1층, 로비)","서울특별시 성동구 매봉길 15(옥수동, 래미안 옥수 리버젠)",2982,1641,456,1143,6,12,2,1,0,6,2,2,0,4,1634,7,1341
161,Seongdong,투표소,OS,옥수동제2투,"옥수동주민센터(4층, 다목적실)",서울특별시 성동구 독서당로 203(옥수동),2741,1365,313,1020,3,11,4,2,0,4,1,1,0,4,1363,2,1376
162,Seongdong,투표소,OS,옥수동제3투,"옥정초등학교(1층, 급식실)",서울특별시 성동구 한림말길 43(옥수동),3068,1610,473,1068,14,12,3,5,0,16,3,0,0,2,1596,14,1458
163,Seongdong,투표소,OS,옥수동제4투,"옥수종합사회복지관(5층, 강당)",서울특별시 성동구 한림말길 16-5(옥수동),3350,1412,293,1080,5,11,1,5,0,2,2,1,0,6,1406,6,1938
164,Seongdong,투표소,OS,옥수동제5투,옥수삼성아파트경로당(한림정)(1층),"서울특별시 성동구 독서당로 218(옥수동, 옥수삼성아파트)",2419,1425,409,984,1,11,1,0,0,5,0,1,0,3,1415,10,994
165,Seongdong,투표소,OS,옥수동제6투,"옥수파크힐스 106동(지하2층, GX룸)","서울특별시 성동구 매봉길 50(옥수동, 이편한세상옥수파크힐스)",3279,1807,478,1292,3,19,2,2,0,2,2,1,0,3,1804,3,1472
166,Seongdong,투표소,EB,응봉동제1투,"응봉동주민센터(3층, 다목적실)",서울특별시 성동구 독서당로 424(응봉동),3239,1326,480,793,6,12,1,3,0,4,7,1,0,2,1309,17,1913
167,Seongdong,투표소,EB,응봉동제2투,"서울응봉초등학교(1층, 체육관)",서울특별시 성동구 독서당로62길 28(응봉동),3535,1704,534,1106,12,18,2,4,0,9,1,1,1,9,1697,7,1831
168,Seongdong,투표소,EB,응봉동제3투,"광희중학교(1층, 보건교육실)",서울특별시 성동구 독서당로62길 46(응봉동),3014,1626,509,1064,7,16,3,9,0,9,0,1,0,5,1623,3,1388
169,Seongdong,투표소,SS11,성수1가제1동제1투,"성수1가제1동주민센터(3층, 다목적실)",서울특별시 성동구 뚝섬로3길 18(성수동1가),2767,1064,385,634,2,15,3,0,0,7,7,0,0,5,1058,6,1703
170,Seongdong,투표소,SS11,성수1가제1동제2투,"경일초등학교(1층, 보건교육실)",서울특별시 성동구 뚝섬로 332(성수동1가),3831,2005,478,1470,6,10,5,7,0,6,1,0,2,11,1996,9,1826
171,Seongdong,투표소,SS11,성수1가제1동제3투,"경일중학교(1층, 체육관)",서울특별시 성동구 성수일로 27(성수동1가),2682,1336,349,942,4,7,2,3,0,10,3,1,1,8,1330,6,1346
172,Seongdong,투표소,SS11,성수1가제1동제4투,"경동초등학교(1층, 방과후대기실)",서울특별시 성동구 성수일로 34(성수동1가),2231,992,331,613,7,5,1,6,0,17,0,0,0,7,987,5,1239
173,Seongdong,투표소,SS12,성수1가제2동제1투,"성수1가제2동 공공복합청사(3층, 다목적실)",서울특별시 성동구 왕십리로5길 3(성수동1가),1801,740,251,443,3,12,3,1,0,7,1,1,1,7,730,10,1061
174,Seongdong,투표소,SS12,성수1가제2동제2투,"성수고등학교 본관(1층, 현관)",서울특별시 성동구 서울숲길 18(성수동1가),993,505,177,304,2,5,0,1,0,4,2,0,0,3,498,7,488
175,Seongdong,투표소,SS12,성수1가제2동제3투,"성동지역경제혁신센터(1층,수다카페)",서울특별시 성동구 상원6나길 22-11(성수동1가),3335,1612,593,952,4,23,0,4,0,15,4,0,0,3,1598,14,1723
176,Seongdong,투표소,SS12,성수1가제2동제4투,쌍용아파트 경로당(1층),"서울특별시 성동구 상원길 63(성수동1가, 쌍용아파트)",3246,1826,590,1171,7,12,3,8,1,8,4,0,3,9,1816,10,1420
177,Seongdong,투표소,SS21,성수2가제1동제1투,"성수2가제1동주민센터(3층, 다목적실)",서울특별시 성동구 뚝섬로 385-19(성수동2가),2762,1128,327,751,7,21,1,0,0,7,2,0,0,4,1120,8,1634
178,Seongdong,투표소,SS21,성수2가제1동제2투,"경수중학교(2관 1층, 체력단련실)",서울특별시 성동구 뚝섬로13길 14(성수동2가),3234,1425,445,930,3,21,1,4,0,8,4,0,0,2,1418,7,1809
179,Seongdong,투표소,SS21,성수2가제1동제3투,"경수초등학교(1층, 녹색어머니회의실)",서울특별시 성동구 뚝섬로13길 22(성수동2가),2892,1011,307,677,3,7,0,2,1,5,1,0,0,3,1006,5,1881
180,Seongdong,투표소,SS21,성수2가제1동제4투,"성원중학교(정보관 1층, 로비)",서울특별시 성동구 성덕정9가길 13(성수동2가),2785,1249,407,790,7,16,0,3,0,9,7,1,0,3,1243,6,1536
181,Seongdong,투표소,SS23,성수2가제3동제1투,"성수2가제3동주민센터(4층, 다목적방)",서울특별시 성동구 광나루로2길 35(성수동2가),3210,1186,445,667,6,17,3,3,1,15,9,0,0,3,1169,17,2024
182,Seongdong,투표소,SS23,성수2가제3동제2투,롯데캐슬파크 경로당(1층),"서울특별시 성동구 성수일로8길 47(성수동2가, 성수동 롯데캐슬파크)",3092,1770,428,1281,3,16,1,2,0,13,0,3,0,8,1755,15,1322
183,Seongdong,투표소,SS23,성수2가제3동제3투,"성수초등학교(1층, 예술꿈뜨락)",서울특별시 성동구 아차산로17길 21(성수동2가),1594,635,241,370,3,7,1,2,0,4,1,1,1,2,633,2,959
184,Seongdong,투표소,WSNDS,왕십리도선동제1투,"한국예술학교(1층, 회의실)",서울특별시 성동구 무학로6길 41(홍익동),2975,1298,490,746,8,20,1,1,1,8,2,1,0,8,1286,12,1677
185,Seongdong,투표소,WSNDS,왕십리도선동제2투,"한서항공직업전문학교(1층, 전시실)",서울특별시 성동구 마장로 208(홍익동),3211,1379,562,742,6,23,0,4,0,14,5,0,1,7,1364,15,1832
186,Seongdong,투표소,WSNDS,왕십리도선동제3투,청계벽산아파트 여자 경로당(1층),"서울특별시 성동구 무학로 50(하왕십리동, 청계벽산아파트)",2532,1554,509,984,6,19,3,4,0,12,2,0,1,3,1543,11,978
187,Seongdong,투표소,WSNDS,왕십리도선동제4투,"왕십리도선동주민센터(지하1층, 어울림방)",서울특별시 성동구 마장로 141(상왕십리동),3956,1670,491,1115,5,12,5,2,0,15,2,0,0,6,1653,17,2286
188,Seongdong,투표소,WSNDS,왕십리도선동제5투,텐즈힐1단지아파트 경로당(1층),"서울특별시 성동구 무학로 33(하왕십리동, 텐즈힐)",3194,1726,541,1124,3,19,1,2,0,9,3,1,1,14,1718,8,1468
189,Seongdong,투표소,WSNDS,왕십리도선동제6투,센트라스아파트 경로당(1층),"서울특별시 성동구 왕십리로 410(하왕십리동, 센트라스)",2728,1401,416,927,3,11,3,2,1,13,0,0,0,7,1383,18,1327
190,Seongdong,투표소,WSN2,왕십리제2동제1투,"이든아이빌(지하1층, 식당)",서울특별시 성동구 왕십리로21라길 11(하왕십리동),3451,1331,546,717,7,20,2,5,0,9,6,1,0,5,1318,13,2120
191,Seongdong,투표소,WSN2,왕십리제2동제2투,"무학초등학교(1층, 회의실)",서울특별시 성동구 무학봉15길 21(하왕십리동),2804,1191,446,688,12,12,3,3,0,11,1,0,0,3,1179,12,1613
192,Seongdong,투표소,WSN2,왕십리제2동제3투,금호베스트빌아파트 관리사무소 앞 경로당(1층),"서울특별시 성동구 난계로 114-31(하왕십리동, 금호베스트빌아파트)",2536,1340,505,775,8,18,2,3,0,5,2,1,0,5,1324,16,1196
193,Seongdong,투표소,WSN2,왕십리제2동제4투,행당역풍림아이원아파트 105동 주민자치센터(1층),"서울특별시 성동구 난계로 84(하왕십리동, 행당역풍림아이원)",2855,1533,604,872,7,15,5,4,0,6,1,0,0,5,1519,14,1322
194,Seongdong,투표소,HD1,행당제1동제1투,"행당1동주민센터(3층, 다목적실)",서울특별시 성동구 고산자로10길 18(행당동),2514,1081,343,684,7,14,0,6,0,9,2,0,1,6,1072,9,1433
195,Seongdong,투표소,HD1,행당제1동제2투,"행당초등학교(1층, 보건교육실)",서울특별시 성동구 고산자로8길 6(행당동),2932,1524,468,1001,8,13,2,7,0,8,2,1,0,7,1517,7,1408
196,Seongdong,투표소,HD1,행당제1동제3투,"무지개 새마을금고[구.행당1동 새마을금고](지하1층, 주차장)",서울특별시 성동구 행당로17길 24-1(행당동),2160,938,354,514,7,19,1,8,1,15,3,0,1,4,927,11,1222
197,Seongdong,투표소,HD1,행당제1동제4투,서울숲리버뷰자이아파트 경로당(1층),"서울특별시 성동구 고산자로2길 65(행당동, 서울숲리버뷰자이)",1875,1121,329,759,6,11,0,1,1,3,4,0,0,3,1117,4,754
198,Seongdong,투표소,HD2,행당제2동제1투,행당대림(아) 제1관리사무소 경로당(1층),"서울특별시 성동구 행당로 79(행당동, 행당동대림아파트)",3350,1739,524,1142,8,20,1,3,0,17,3,0,0,7,1725,14,1611
199,Seongdong,투표소,HD2,행당제2동제2투,"행당제2동주민센터(2층, 다목적방)",서울특별시 성동구 행당로9길 9(행당동),2974,1277,438,780,8,13,0,5,0,12,5,2,0,3,1266,11,1697
200,Seongdong,투표소,HD2,행당제2동제3투,행당대림(아) 제2관리사무소 경로당(1층),"서울특별시 성동구 행당로 79(행당동, 행당동대림아파트)",3090,1594,621,911,10,17,0,5,0,9,6,0,1,3,1583,11,1496
201,Seongdong,투표소,HD2,행당제2동제4투,행당한진타운(아) 제1관리사무소 경로당(1층),"서울특별시 성동구 행당로 82(행당동, 행당 한진타운)",2794,1600,469,1065,7,24,1,2,0,17,3,2,0,4,1594,6,1194
202,Seongdong,투표소,HD2,행당제2동제5투,행당한진타운(아) 제2관리사무소 경로당(1층),"서울특별시 성동구 행당로 82(행당동, 행당 한진타운)",2983,1541,573,919,6,11,1,4,0,2,3,1,0,3,1523,18,1442
203,Seongdong,투표소,MJ,마장동제1투,마주보고카페(1층),서울특별시 성동구 마장로42길 11(마장동),2462,1108,399,663,4,18,2,2,0,6,2,0,0,6,1102,6,1354
204,Seongdong,투표소,MJ,마장동제2투,"시립성동노인종합복지관(1층, 로비)",서울특별시 성동구 마조로 77(마장동),2894,1513,564,865,16,25,2,0,0,16,4,1,0,5,1498,15,1381
205,Seongdong,투표소,MJ,마장동제3투,"마장중학교(1층, 기술실습실)",서울특별시 성동구 마장로35나길 31(마장동),3076,1536,549,918,11,20,1,2,0,13,3,1,0,6,1524,12,1540
206,Seongdong,투표소,MJ,마장동제4투,"동명초등학교(1층, 체육관)",서울특별시 성동구 마장로29길 29(마장동),2421,1091,456,587,6,15,2,3,0,6,6,1,1,2,1085,6,1330
207,Seongdong,투표소,MJ,마장동제5투,"성동구도시관리공단(1층, 대회의실)",서울특별시 성동구 청계천로 546(마장동),2688,1164,477,640,8,15,2,2,0,6,2,0,1,4,1157,7,1524
208,Seongdong,투표소,MJ,마장동제6투,"금호어울림아파트 관리사무소(1층, 회의실)","서울특별시 성동구 마조로 57(마장동, 금호어울림아파트)",2630,1286,450,747,15,19,3,5,0,15,2,0,0,10,1266,20,1344
209,Seongdong,투표소,SK,사근동제1투,"사근동주민센터(지하1층, 다목적실)",서울특별시 성동구 사근동길 37(사근동),1986,876,315,502,11,7,4,6,0,10,2,0,1,2,860,16,1110
210,Seongdong,투표소,SK,사근동제2투,"사근초등학교(1층, 영어체험실)",서울특별시 성동구 사근동11길 16(사근동),2520,1009,381,570,10,15,1,0,0,9,4,0,1,5,996,13,1511
211,Seongdong,투표소,SK,사근동제3투,"한양대학교사범대학부속중학교(1층, 창작공작소)",서울특별시 성동구 마조로 42(사근동),4387,1643,459,1077,21,13,7,11,0,18,5,0,2,7,1620,23,2744
212,Seongdong,투표소,SJ,송정동제1투,"송정동주민센터(2층, 회의실)",서울특별시 성동구 동일로43길 13(송정동),2651,1072,432,603,5,6,3,2,0,3,4,0,0,4,1062,10,1579
213,Seongdong,투표소,SJ,송정동제2투,"서울송원초등학교(1층, 1-1반)",서울특별시 성동구 동일로43길 9(송정동),2488,1029,392,595,3,16,0,3,0,7,4,0,2,0,1022,7,1459
214,Seongdong,투표소,SJ,송정동제3투,"성동세무서(1층, 로비)",서울특별시 성동구 광나루로 297(송정동),2543,1081,386,639,4,17,3,1,1,8,3,2,1,6,1071,10,1462
215,Seongdong,투표소,YD,용답동제1투,"용답동주민센터(3층, 다목적실)",서울특별시 성동구 용답중앙23길 20(용답동),3687,1209,515,635,9,11,1,2,0,13,4,0,0,6,1196,13,2478
216,Seongdong,투표소,YD,용답동제2투,"성동구립용답도서관(지하1층, 문화강좌실)",서울특별시 성동구 용답중앙3길 10(용답동),2838,1121,449,614,4,14,3,0,1,12,8,2,0,7,1114,7,1717
217,Seongdong,투표소,YD,용답동제3투,"용답초등학교(지하1층, 강당)",서울특별시 성동구 용답25길 1(용답동),2278,956,368,553,3,9,0,2,0,6,4,0,1,1,947,9,1322
218,Gwangjin,투표소,JK1,중곡제1동제1투,"중곡제1동주민센터(지하1층, 자원봉사캠프)",서울특별시 광진구 긴고랑로12길 49(중곡동),3470,1327,542,697,7,29,3,2,0,18,6,0,0,8,1312,15,2143
219,Gwangjin,투표소,JK1,중곡제1동제2투,"중곡제1동주민센터 (2층, 회의실)",서울특별시 광진구 긴고랑로12길 49(중곡동),2199,900,364,479,3,16,1,2,0,18,3,0,0,3,889,11,1299
220,Gwangjin,투표소,JK1,중곡제1동제3투,"서울중마초등학교 어울림관 (1층, 영어1실)",서울특별시 광진구 동일로72길 43(중곡동),2905,1267,538,669,7,21,0,2,0,11,5,2,0,3,1258,9,1638
221,Gwangjin,투표소,JK1,중곡제1동제4투,"중곡제1동주민센터 (3층, 자치회관)",서울특별시 광진구 긴고랑로12길 49(중곡동),2603,1062,435,574,4,22,3,1,0,6,1,0,0,5,1051,11,1541
222,Gwangjin,투표소,JK2,중곡제2동제1투,"중곡제2동주민센터 (3층, 강당)",서울특별시 광진구 능동로 346(중곡동),2936,1158,476,618,7,14,1,3,1,15,4,1,2,6,1148,10,1778
223,Gwangjin,투표소,JK2,중곡제2동제2투,"용마초등학교 (서관2층, 교과1실(돌봄2반))",서울특별시 광진구 천호대로113길 10(중곡동),3193,1367,573,723,13,16,2,2,0,16,3,0,0,6,1354,13,1826
224,Gwangjin,투표소,JK2,중곡제2동제3투,"용마초등학교 (서관2층, 교과2실(돌봄3반))",서울특별시 광진구 천호대로113길 10(중곡동),3596,1494,585,820,12,16,2,5,0,30,5,1,0,6,1482,12,2102
225,Gwangjin,투표소,JK2,중곡제2동제4투,"용마초등학교 (서관1층, 영어전용실)",서울특별시 광진구 천호대로113길 10(중곡동),2385,914,355,525,5,11,0,1,0,5,2,2,0,2,908,6,1471
226,Gwangjin,투표소,JK2,중곡제2동제5투,"중곡종합건강센터 (5층, 보건교육실)",서울특별시 광진구 긴고랑로 110(중곡동),3199,1305,526,720,7,13,1,5,0,14,6,0,2,1,1295,10,1894
227,Gwangjin,투표소,JK3,중곡제3동제1투,"중곡문화체육센터 도서관(2층, 로비)",서울특별시 광진구 능동로 433(중곡동),2359,1090,471,571,8,12,2,2,0,13,3,1,0,3,1086,4,1269
228,Gwangjin,투표소,JK3,중곡제3동제2투,"중광초등학교 (2층, 1-2반)",서울특별시 광진구 긴고랑로13길 59(중곡동),2244,1013,393,562,13,18,1,4,0,6,2,1,0,3,1003,10,1231
229,Gwangjin,투표소,JK3,중곡제3동제3투,"중마초등학교(1층, 별관 지혜반)",서울특별시 광진구 동일로72길 43(중곡동),2480,991,394,545,6,22,2,3,0,5,4,0,1,1,983,8,1489
230,Gwangjin,투표소,JK3,중곡제3동제4투,"중곡제3동주민센터 (지하1층, 다목적실)",서울특별시 광진구 동일로76가길 28(중곡동),2676,1048,415,585,2,17,3,3,0,5,3,2,2,1,1038,10,1628
231,Gwangjin,투표소,JK3,중곡제3동제5투,"중곡제3동주민센터 (1층, 북카페)",서울특별시 광진구 동일로76가길 28(중곡동),2328,830,312,485,4,8,1,5,0,6,2,1,0,0,824,6,1498
232,Gwangjin,투표소,JK4,중곡제4동제1투,금명빌 주차장(1층),서울특별시 광진구 용마산로 104(중곡동),2736,1292,485,743,8,21,0,4,0,12,5,1,0,3,1282,10,1444
233,Gwangjin,투표소,JK4,중곡제4동제2투,"SK아파트정문앞 리안빌 주차장 (1층, 주차장)",서울특별시 광진구 용마산로32길 9(중곡동),3227,1669,722,873,10,20,1,5,0,11,2,2,0,10,1656,13,1558
234,Gwangjin,투표소,JK4,중곡제4동제3투,"중곡제4동주민센터 (3층, 문화강좌실)",서울특별시 광진구 긴고랑로 131(중곡동),2808,1127,453,616,8,15,4,3,0,8,2,0,0,6,1115,12,1681
235,Gwangjin,투표소,JK4,중곡제4동제4투,"다가구주차장 (1층, 주차장)",서울특별시 광진구 용마산로8길 81(중곡동),2655,1154,468,629,8,20,1,3,0,7,5,1,0,4,1146,8,1501
236,Gwangjin,투표소,JK4,중곡제4동제5투,"대원경로당 (1층, 할머니방)",서울특별시 광진구 긴고랑로36길 57-27(중곡동),3122,1350,543,743,6,24,1,6,0,5,2,0,0,10,1340,10,1772
237,Gwangjin,투표소,JK4,중곡제4동제6투,"중곡제4동주민센터 (1층, 새마을문고실)",서울특별시 광진구 긴고랑로 131(중곡동),2825,1195,426,704,8,23,3,2,0,12,5,2,1,4,1190,5,1630
238,Gwangjin,투표소,JK4,중곡제4동제7투,"웨딩부띠크 르블랑(1층, 로비)",서울특별시 광진구 천호대로 643(중곡동),3361,1725,683,969,11,23,2,3,1,6,7,0,1,7,1713,12,1636
239,Gwangjin,투표소,N,능동제1투,"능동주민센터 (3층, 강당)",서울특별시 광진구 천호대로112길 55(능동),2317,944,346,529,4,18,5,4,0,14,3,0,1,4,928,16,1373
240,Gwangjin,투표소,N,능동제2투,"능동주민센터 (지하1층, 주차장)",서울특별시 광진구 천호대로112길 55(능동),2740,1167,440,641,8,17,3,3,0,21,6,0,0,7,1146,21,1573
241,Gwangjin,투표소,N,능동제3투,"기아자동차 대공원대리점 (1층, 전시장)",서울특별시 광진구 천호대로 636(능동),3176,1574,608,878,14,25,1,3,0,19,5,2,1,7,1563,11,1602
242,Gwangjin,투표소,KU1,구의제1동제1투,"구의제1동주민센터(4층, 대강당)",서울특별시 광진구 광나루로36길 56(구의동),3061,1216,448,692,14,20,2,1,1,9,4,0,0,11,1202,14,1845
243,Gwangjin,투표소,KU1,구의제1동제2투,"구의초등학교 해오름관 (1층, 강당)",서울특별시 광진구 광나루로30길 49(화양동),3205,1381,525,780,7,19,5,4,0,16,7,2,0,3,1368,13,1824
244,Gwangjin,투표소,KU1,구의제1동제3투,"동국대학교사범대학부속여자중학교 (1층, 진로활동실)",서울특별시 광진구 광나루로36길 47(구의동),3196,1314,499,737,9,22,3,4,1,12,3,1,1,6,1298,16,1882
245,Gwangjin,투표소,KU1,구의제1동제4투,"동국대학교사범대학부속여자중학교 (1층, 음악1실)",서울특별시 광진구 광나루로36길 47(구의동),2892,1143,428,647,10,19,3,0,0,11,4,0,0,6,1128,15,1749
246,Gwangjin,투표소,KU1,구의제1동제5투,"구의제1동주민센터(지하1층, 주차장)",서울특별시 광진구 광나루로36길 56(구의동),3256,1258,484,690,15,13,8,4,0,21,1,0,0,8,1244,14,1998
247,Gwangjin,투표소,KU2,구의제2동제1투,"광진초등학교 (1층, 로비)",서울특별시 광진구 자양로40길 41(구의동),2739,1121,445,616,5,15,1,6,0,11,3,0,0,7,1109,12,1618
248,Gwangjin,투표소,KU2,구의제2동제2투,"래미안파크스위트 (1층, 시니어스클럽)","서울특별시 광진구 광나루로 545(구의동, 래미안파크스위트)",2524,1390,454,884,8,15,2,4,0,7,4,0,0,2,1380,10,1134
249,Gwangjin,투표소,KU2,구의제2동제3투,"소능경로당(1층, 할머니방)",서울특별시 광진구 자양로37길 85(구의동),2460,1138,489,599,9,15,2,2,0,10,0,0,0,2,1128,10,1322
250,Gwangjin,투표소,KU2,구의제2동제4투,"CH697 (1층, 커피숍)",서울특별시 광진구 천호대로 6971층(구의동),3456,1709,688,945,7,23,3,3,1,14,3,2,1,10,1700,9,1747
251,Gwangjin,투표소,KU2,구의제2동제5투,"세진빌딩 301호 (3층, 사단법인광진구장애인단체총연합회)",서울특별시 광진구 천호대로 677(구의동),3475,1600,639,913,5,16,1,3,0,11,2,0,1,3,1594,6,1875
252,Gwangjin,투표소,KU2,구의제2동제6투,"동의초등학교 (2층, 본관 1-1반)",서울특별시 광진구 영화사로 111(구의동),3703,1699,716,913,12,15,5,6,0,13,4,0,0,8,1692,7,2004
253,Gwangjin,투표소,KU3,구의제3동제1투,"광진구민방위교육센터 (1층, 로비)",서울특별시 광진구 광나루로56길 8(구의동),2918,1724,448,1226,5,13,4,3,0,12,1,0,1,4,1717,7,1194
254,Gwangjin,투표소,KU3,구의제3동제2투,"구의제3동주민센터(2층, 다목적실)",서울특별시 광진구 강변역로 17(구의동),3182,1421,537,812,6,17,5,4,0,20,2,0,1,1,1405,16,1761
255,Gwangjin,투표소,KU3,구의제3동제3투,"산의마을경로당 (1층, 할머니방)",서울특별시 광진구 아차산로63길 21(구의동),3913,1874,688,1104,5,18,4,3,0,22,4,1,1,5,1855,19,2039
256,Gwangjin,투표소,KU3,구의제3동제4투,"구의제3동주민센터 (5층, 대강당)",서울특별시 광진구 강변역로 17(구의동),2868,1502,431,1013,8,7,5,1,2,16,2,1,0,3,1489,13,1366
257,Gwangjin,투표소,KU3,구의제3동제5투,"구남초등학교 (1층, 로비)",서울특별시 광진구 구의강변로 69(구의동),3693,2070,677,1313,4,21,2,5,0,21,3,1,0,6,2053,17,1623
258,Gwangjin,투표소,KU3,구의제3동제6투,"광진문화원 (1층, 문화카페)",서울특별시 광진구 광나루로56길 67(구의동),2937,1830,434,1337,5,17,1,2,1,10,1,1,0,5,1814,16,1107
259,Gwangjin,투표소,KJ,광장동제1투,"광장중학교 (1층, 기술실)",서울특별시 광진구 광장로1길 1(광장동),3770,1708,462,1196,9,14,1,3,0,6,3,0,0,5,1699,9,2062
260,Gwangjin,투표소,KJ,광장동제2투,"광장초등학교 (1층, 다목적실)",서울특별시 광진구 광장로1길 27(광장동),2784,1518,329,1135,8,8,5,2,1,7,2,0,0,4,1501,17,1266
261,Gwangjin,투표소,KJ,광장동제3투,"양진중학교(1층, 다목적실)",서울특별시 광진구 워커힐로 32(광장동),3276,1756,635,1067,4,16,3,2,0,11,3,0,0,6,1747,9,1520
262,Gwangjin,투표소,KJ,광장동제4투,"광남중학교(1층, 진로활동실)",서울특별시 광진구 아차산로70길 17-62(광장동),3215,1787,630,1097,8,13,0,6,0,9,3,1,0,5,1772,15,1428
263,Gwangjin,투표소,KJ,광장동제5투,"광남초등학교 (1층, 음악실)",서울특별시 광진구 아차산로70길 35(광장동),3960,2110,716,1332,8,11,3,4,0,12,3,2,0,2,2093,17,1850
264,Gwangjin,투표소,KJ,광장동제6투,"광남중학교 (1층, 다목적실)",서울특별시 광진구 아차산로70길 17-62(광장동),3167,1834,497,1292,4,7,0,4,0,11,0,0,0,4,1819,15,1333
265,Gwangjin,투표소,JY1,자양제1동제1투,"자양제1동주민센터 (3층, 대강당)",서울특별시 광진구 자양로13길 37(자양동),2762,1001,396,555,6,11,7,1,0,10,3,0,0,0,989,12,1761
266,Gwangjin,투표소,JY1,자양제1동제2투,"자양초등학교 병설유치원 (3층, 신체활동실)",서울특별시 광진구 아차산로44길 26(자양동),2635,1204,468,681,6,9,5,4,0,14,5,0,0,6,1198,6,1431
267,Gwangjin,투표소,JY1,자양제1동제3투,"광진구청 안전관리동 (3층, 대강당)",서울특별시 광진구 자양로 117(자양동),3568,1549,582,883,8,23,8,3,0,10,7,2,1,7,1534,15,2019
268,Gwangjin,투표소,JY1,자양제1동제4투,"중앙농협 (4층, 대강당)",서울특별시 광진구 뚝섬로 639(자양동),2087,922,370,520,5,11,3,2,1,3,3,0,0,2,920,2,1165
269,Gwangjin,투표소,JY1,자양제1동제5투,"자양초등학교 병설유치원 (3층, 제1과학실)",서울특별시 광진구 아차산로44길 26(자양동),2374,822,340,443,5,14,1,3,0,4,3,0,0,7,820,2,1552
270,Gwangjin,투표소,JY1,자양제1동제6투,"자양초등학교 병설유치원 (3층, 실과실)",서울특별시 광진구 아차산로44길 26(자양동),2440,946,343,565,2,14,2,2,1,5,3,0,0,4,941,5,1494
271,Gwangjin,투표소,JY2,자양제2동제1투,"자양제2동주민센터 (3층, 회의실)",서울특별시 광진구 자양로3가길 26(자양동),2981,1463,456,961,2,15,1,1,0,11,4,1,0,3,1455,8,1518
272,Gwangjin,투표소,JY2,자양제2동제2투,"광진중학교 (후관 1층, 과학실험실 3실)",서울특별시 광진구 뚝섬로64길 45(자양동),2988,1621,476,1089,6,9,5,5,0,19,1,0,0,3,1613,8,1367
273,Gwangjin,투표소,JY2,자양제2동제3투,"광양중학교 (1층, 체육교과실)",서울특별시 광진구 자양로3길 7(자양동),2811,1263,451,750,7,20,2,6,0,7,4,0,0,4,1251,12,1548
274,Gwangjin,투표소,JY2,자양제2동제4투,"광양고등학교 (정보관동 1층, 진로실)",서울특별시 광진구 자양로3가길 31(자양동),2656,1244,432,773,2,7,5,2,0,7,4,0,0,3,1235,9,1412
275,Gwangjin,투표소,JY2,자양제2동제5투,"성자초등학교 (해오름 1층, 과학실)",서울특별시 광진구 뚝섬로56길 7(자양동),2591,1141,455,623,5,18,5,3,0,16,1,1,1,3,1131,10,1450
276,Gwangjin,투표소,JY2,자양제2동제6투,"신자초등학교 (꿈이랑 1층, 시청각실)",서울특별시 광진구 뚝섬로46길 64(자양동),3097,1422,561,810,8,7,7,2,0,13,0,0,1,9,1418,4,1675
277,Gwangjin,투표소,JY3,자양제3동제1투,"자양제3동주민센터 (3층,대강당)",서울특별시 광진구 뚝섬로 568(자양동),2724,1269,409,820,4,10,5,2,0,6,3,0,0,1,1260,9,1455
278,Gwangjin,투표소,JY3,자양제3동제2투,"신양초등학교 (1층, 제1과학실)",서울특별시 광진구 능동로 42(자양동),3053,1511,456,1020,5,12,1,0,0,3,4,0,0,7,1508,3,1542
279,Gwangjin,투표소,JY3,자양제3동제3투,"신양초등학교 (1층, 제2과학실)",서울특별시 광진구 능동로 42(자양동),2590,1426,422,957,4,4,5,1,0,14,2,0,0,7,1416,10,1164
280,Gwangjin,투표소,JY3,자양제3동제4투,"동자초등학교 (1층, 보건교육실)",서울특별시 광진구 뚝섬로 561(자양동),2299,1256,424,783,7,12,2,6,0,4,3,0,1,1,1243,13,1043
281,Gwangjin,투표소,JY3,자양제3동제5투,"동자초등학교 (1층, 1-2반)",서울특별시 광진구 뚝섬로 561(자양동),2230,1246,342,859,6,12,5,0,0,9,0,2,1,2,1238,8,984
282,Gwangjin,투표소,JY3,자양제3동제6투,"자양중학교 (1층, 교직원식당)",서울특별시 광진구 뚝섬로41길 33(자양동),1680,687,260,403,3,4,1,1,0,6,1,0,0,1,680,7,993
283,Gwangjin,투표소,JY3,자양제3동제7투,"광진문화재단 나루아트센터(1층, 전시실)",서울특별시 광진구 능동로 76(자양동),3036,1890,300,1549,2,12,1,1,1,7,0,1,0,6,1880,10,1146
284,Gwangjin,투표소,JY4,자양제4동제1투,"자양제4동주민센터 (3층, 문화교실)",서울특별시 광진구 뚝섬로26길 58(자양동),2206,862,291,542,4,4,1,4,0,7,0,0,1,0,854,8,1344
285,Gwangjin,투표소,JY4,자양제4동제2투,"신양중학교 (1층, 보건교육실)",서울특별시 광진구 자양강변길 73(자양동),2366,1137,336,761,4,12,2,3,0,5,1,0,1,5,1130,7,1229
286,Gwangjin,투표소,JY4,자양제4동제3투,"신양중학교 (1층, 다목적실)",서울특별시 광진구 자양강변길 73(자양동),2037,856,245,579,8,7,2,1,0,4,2,0,0,3,851,5,1181
287,Gwangjin,투표소,JY4,자양제4동제4투,"동부여성발전센터 (2층, 오렌지움)",서울특별시 광진구 아차산로30길 36(자양동),2314,928,356,524,3,15,6,1,0,5,2,1,1,2,916,12,1386
288,Gwangjin,투표소,JY4,자양제4동제5투,"동부여성발전센터 (1층, 로비)",서울특별시 광진구 아차산로30길 36(자양동),2449,1045,374,613,4,18,2,4,1,8,4,0,0,4,1032,13,1404
289,Gwangjin,투표소,JY4,자양제4동제6투,"동부여성발전센터 (2층, 대강당)",서울특별시 광진구 아차산로30길 36(자양동),1787,814,307,477,5,7,4,0,0,6,1,1,0,1,809,5,973
290,Gwangjin,투표소,HY,화양동제1투,"화양동주민센터 (4층, 대강당)",서울특별시 광진구 능동로17길 39(화양동),5337,1671,531,980,20,26,8,9,0,35,9,1,2,17,1638,33,3666
291,Gwangjin,투표소,HY,화양동제2투,"화양초등학교 (1층, 중앙로비)",서울특별시 광진구 군자로 9(화양동),3020,1152,394,668,11,15,3,4,0,27,5,1,0,9,1137,15,1868
292,Gwangjin,투표소,HY,화양동제3투,"화양초등학교 (1층, 돌봄교실)",서울특별시 광진구 군자로 9(화양동),3139,1090,347,672,6,14,3,3,0,12,3,0,2,9,1071,19,2049
293,Gwangjin,투표소,HY,화양동제4투,"화양동주민센터(3층, 회의실)",서울특별시 광진구 능동로17길 39(화양동),2530,734,241,434,7,9,3,4,0,11,6,0,0,5,720,14,1796
294,Gwangjin,투표소,HY,화양동제5투,"한아름쇼핑센터(1층, 으뜸안경)",서울특별시 광진구 능동로13길 39(화양동),2625,974,334,565,8,18,5,5,0,14,3,0,1,6,959,15,1651
295,Gwangjin,투표소,HY,화양동제6투,"화양동주민센터 (1층, 주민사랑방)",서울특별시 광진구 능동로17길 39(화양동),1844,655,212,393,3,10,2,0,1,15,2,1,0,2,641,14,1189
296,Gwangjin,투표소,KJ,군자동제1투,"군자동주민센터 (2층, 강당)",서울특별시 광진구 군자로 151(군자동),2918,1169,419,682,8,22,1,5,1,9,4,0,1,6,1158,11,1749
297,Gwangjin,투표소,KJ,군자동제2투,"쉐보레 동서울대리점 (1층, 전시장)",서울특별시 광진구 천호대로 536(군자동),2343,999,400,528,5,11,3,4,0,18,7,0,0,11,987,12,1344
298,Gwangjin,투표소,KJ,군자동제3투,"세종대학교 기숙사 새날관(1층, 103호)",서울특별시 광진구 군자로 121(군자동),2244,838,311,491,9,8,0,2,0,3,1,0,0,1,826,12,1406
299,Gwangjin,투표소,KJ,군자동제4투,"세종대학교 기숙사 새날관(1층, 101C호)",서울특별시 광진구 군자로 121(군자동),2326,1016,424,533,6,14,6,4,0,10,5,0,0,5,1007,9,1310
300,Gwangjin,투표소,KJ,군자동제5투,"장안초등학교 중앙관 (1층, 로비)",서울특별시 광진구 군자로 74(군자동),2294,1109,383,681,1,17,4,2,0,6,1,0,0,5,1100,9,1185
301,Gwangjin,투표소,KJ,군자동제6투,"광진노인종합복지관(지하2층, 강당)",서울특별시 광진구 군자로 88(군자동),2664,1107,418,628,7,10,1,10,1,8,3,1,0,6,1093,14,1557
302,Dongdaemun,투표소,YS,용신동제1투,"용신동주민센터(5층, 강당)",서울특별시 동대문구 천호대로27길 35(용두동),3074,1262,406,808,2,17,3,2,0,6,2,1,0,4,1251,11,1812
303,Dongdaemun,투표소,YS,용신동제2투,"용두문화복지센터(3층, 1교육장)",서울특별시 동대문구 고산자로28길 13(용두동),3067,1301,507,737,5,15,2,1,0,12,5,0,1,5,1290,11,1766
304,Dongdaemun,투표소,YS,용신동제3투,"동대문구청(2층, 다목적강당)",서울특별시 동대문구 천호대로 145(용두동),3054,1165,475,658,1,8,1,2,0,5,5,0,0,5,1160,5,1889
305,Dongdaemun,투표소,YS,용신동제4투,"용두초등학교(2층, 체육관)",서울특별시 동대문구 천호대로13길 43(용두동),2570,1140,428,661,10,9,1,1,0,11,2,0,0,4,1127,13,1430
306,Dongdaemun,투표소,YS,용신동제5투,"용두초등학교(2층, 체육관)",서울특별시 동대문구 천호대로13길 43(용두동),3240,1176,413,687,11,9,3,6,0,20,4,0,1,4,1158,18,2064
307,Dongdaemun,투표소,YS,용신동제6투,"용두청소년독서실(7층, 다목적강당)",서울특별시 동대문구 한빛로 62(용두동),1298,518,174,308,5,5,0,3,0,7,2,0,0,5,509,9,780
308,Dongdaemun,투표소,YS,용신동제7투,"렛츠런동대문문화공감센터[(구)한국마사회](1층,로비)",서울특별시 동대문구 난계로 254(신설동),3517,1257,491,693,7,11,1,6,0,25,3,0,0,9,1246,11,2260
309,Dongdaemun,투표소,YS,용신동제8투,"동대문장애인종합복지관(지하1층, 집단활동실)",서울특별시 동대문구 청계천로 521(용두동),3276,1378,578,740,8,17,3,3,0,8,3,1,0,5,1366,12,1898
310,Dongdaemun,투표소,JK,제기동제1투,"정화여중·상업고등학교 별관(1층, 헤어미용실습실)",서울특별시 동대문구 홍릉로15길 49(제기동),3336,1366,463,845,5,11,3,3,0,7,3,1,0,2,1343,23,1970
311,Dongdaemun,투표소,JK,제기동제2투,"홍파초등학교(1층, 로비)",서울특별시 동대문구 고산자로 518(제기동),3020,1453,449,964,1,11,1,0,0,7,2,0,0,9,1444,9,1567
312,Dongdaemun,투표소,JK,제기동제3투,"제기동주민센터(4층, 다목적강당)",서울특별시 동대문구 약령시로 71(제기동),3048,1183,394,742,5,15,0,1,0,9,6,0,0,3,1175,8,1865
313,Dongdaemun,투표소,JK,제기동제4투,"동대문종합사회복지관(1층, 로비)",서울특별시 동대문구 약령시로5길 22(제기동),3038,1347,447,815,17,16,2,2,2,9,5,1,0,12,1328,19,1691
314,Dongdaemun,투표소,JK,제기동제5투,"종암초등학교 서관(1층, 체육꿈실)",서울특별시 동대문구 무학로44길 25(제기동),2592,1324,478,802,4,14,2,5,0,6,2,0,0,5,1318,6,1268
315,Dongdaemun,투표소,JK,제기동제6투,"성일중학교(1층, 로비)",서울특별시 동대문구 왕산로23길 55(제기동),2896,1388,490,837,5,14,5,2,0,12,5,1,0,6,1377,11,1508
316,Dongdaemun,투표소,JN1,전농제1동제1투,"전농1동주민센터(3층, 회의실)",서울특별시 동대문구 서울시립대로9길 21(전농동),2777,1084,442,593,7,14,0,2,0,7,5,1,2,2,1075,9,1693
317,Dongdaemun,투표소,JN1,전농제1동제2투,"롯데캐슬아파트(1층, 독서실)","서울특별시 동대문구 답십리로23길 301층 독서실 (전농동, 동대문 롯데캐슬 노블레스)",2791,1276,455,778,2,18,1,4,0,9,1,0,0,5,1273,3,1515
318,Dongdaemun,투표소,JN1,전농제1동제3투,"전일청소년독서실 전일자치회관(5층, 로비)",서울특별시 동대문구 전농로37길 17(전농동),3618,1529,554,884,10,12,1,3,1,19,4,1,1,16,1506,23,2089
319,Dongdaemun,투표소,JN1,전농제1동제4투,화목경로당(1층),서울특별시 동대문구 전농로31길 33(전농동),2493,1113,406,656,4,16,1,1,0,11,3,0,1,2,1101,12,1380
320,Dongdaemun,투표소,JN1,전농제1동제5투,래미안크레시티303동독서실(1층),서울특별시 동대문구 사가정로 65(전농동),2507,1011,380,595,4,8,0,1,1,6,0,1,0,3,999,12,1496
321,Dongdaemun,투표소,JN1,전농제1동제6투,대한노인회동대문지회(1층),서울특별시 동대문구 사가정로 98(전농동),2118,930,378,519,3,8,0,3,1,4,3,1,0,6,926,4,1188
322,Dongdaemun,투표소,JN1,전농제1동제7투,"래미안크레시티303동(1층, 회의실)",서울특별시 동대문구 사가정로 65(전농동),2183,1232,437,753,5,11,1,2,0,10,5,0,0,1,1225,7,951
323,Dongdaemun,투표소,JN1,전농제1동제8투,"래미안크레시티204동(1층, 경로당)",서울특별시 동대문구 사가정로 65(전농동),2530,1539,497,978,5,19,2,2,0,15,5,0,1,4,1528,11,991
324,Dongdaemun,투표소,JN2,전농제2동제1투,전곡초등학교 체육관(1층),서울특별시 동대문구 전농로 172(전농동),2014,966,327,594,11,10,1,5,0,4,1,2,2,2,959,7,1048
325,Dongdaemun,투표소,JN2,전농제2동제2투,"SK아파트 제1경로당(1층, 할아버지방)",서울특별시 동대문구 사가정로 148(전농동),2774,1595,542,1002,3,17,5,1,0,8,5,1,1,4,1589,6,1179
326,Dongdaemun,투표소,JN2,전농제2동제3투,"SK아파트 제1경로당(1층, 할머니방)",서울특별시 동대문구 사가정로 148(전농동),2171,1018,368,612,5,10,1,2,0,8,1,2,0,1,1010,8,1153
327,Dongdaemun,투표소,JN2,전농제2동제4투,"배봉초등학교(1층, 후관로비)",서울특별시 동대문구 사가정로 193(전농동),3453,1508,534,922,5,17,3,3,0,9,1,0,0,2,1496,12,1945
328,Dongdaemun,투표소,JN2,전농제2동제5투,"전농2동주민센터(5층, 강당)",서울특별시 동대문구 사가정로 137(전농동),1980,906,343,530,3,12,0,6,0,5,2,0,0,3,904,2,1074
329,Dongdaemun,투표소,DSN1,답십리제1동제1투,"답십리1동주민센터(3층, 북카페)",서울특별시 동대문구 사가정로 30(답십리동),2882,996,356,556,14,16,5,4,0,19,6,0,0,8,984,12,1886
330,Dongdaemun,투표소,DSN1,답십리제1동제2투,"답십리초등학교(1층, 2-1반)",서울특별시 동대문구 전농로3길 23(답십리동),2993,1260,479,728,9,10,2,1,1,10,5,0,1,4,1250,10,1733
331,Dongdaemun,투표소,DSN1,답십리제1동제3투,"래미안위브309동(1층, 다목적실)",서울특별시 동대문구 답십리로 130(답십리동),2342,1373,429,895,5,10,0,5,0,8,3,1,0,5,1361,12,969
332,Dongdaemun,투표소,DSN1,답십리제1동제4투,"래미안위브107동(1층, 주민회의실)",서울특별시 동대문구 답십리로 130(답십리동),2522,1330,484,810,3,14,1,2,0,2,1,0,0,4,1321,9,1192
333,Dongdaemun,투표소,DSN1,답십리제1동제5투,"전농초등학교(2층, 강당)","서울특별시 동대문구 사가정로 66(전농동) 전농초등학교(2층, 강당)",3122,1452,549,868,1,9,3,3,0,6,2,0,1,4,1446,6,1670
334,Dongdaemun,투표소,DSN1,답십리제1동제6투,"답십리도서관(1층, 로비)",서울특별시 동대문구 서울시립대로4길 75(답십리동),1914,968,394,537,6,10,2,5,1,4,0,0,1,2,962,6,946
335,Dongdaemun,투표소,DSN1,답십리제1동제7투,청계한신휴플러스경로당(1층),서울특별시 동대문구 서울시립대로 14(답십리동),3676,1989,706,1206,6,18,6,10,1,15,3,0,1,6,1978,11,1687
336,Dongdaemun,투표소,DSN2,답십리제2동제1투,"답십리2동주민센터(2층, 열린문고)",서울특별시 동대문구 한천로11길 18(답십리동),3623,1425,536,833,4,19,0,3,0,11,1,1,1,9,1418,7,2198
337,Dongdaemun,투표소,DSN2,답십리제2동제2투,"답십리2동주민센터(4층, 다목적실)",서울특별시 동대문구 한천로11길 18(답십리동),2381,1123,432,652,3,15,1,1,1,4,4,1,1,5,1120,3,1258
338,Dongdaemun,투표소,DSN2,답십리제2동제3투,"동답초등학교(1층, 로비)","서울특별시 동대문구 답십리로60길 12(1층, 로비) (답십리동)",1988,987,376,576,5,13,1,2,0,3,3,0,2,1,982,5,1001
339,Dongdaemun,투표소,DSN2,답십리제2동제4투,우성그린아파트경로당(1층),서울특별시 동대문구 답십리로59길 33(답십리동),2740,1446,596,803,8,14,1,0,0,7,6,0,1,1,1437,9,1294
340,Dongdaemun,투표소,DSN2,답십리제2동제5투,두산아파트경로당(1층),서울특별시 동대문구 답십리로56길 21(답십리동),2818,1529,590,887,6,15,2,3,1,7,2,1,0,4,1518,11,1289
341,Dongdaemun,투표소,DSN2,답십리제2동제6투,청솔우성아파트경로당(1층),서울특별시 동대문구 전농로10길 20(답십리동),3158,1814,708,1053,6,14,2,4,0,11,4,0,0,0,1802,12,1344
342,Dongdaemun,투표소,DSN2,답십리제2동제7투,구립답십리2동청소년독서실(1층),서울특별시 동대문구 답십리로56길 15(답십리동),3194,1306,520,744,5,13,1,3,0,9,1,1,2,1,1300,6,1888
343,Dongdaemun,투표소,JA1,장안제1동제1투,"장안종합사회복지관(1층, 강당)",서울특별시 동대문구 한천로18길 48(장안동),3484,1283,529,703,8,10,0,2,0,9,2,0,1,3,1267,16,2201
344,Dongdaemun,투표소,JA1,장안제1동제2투,"삼성쉐르빌쇼핑타운(1층, 로비)",서울특별시 동대문구 장한로 119(장안동),3848,1678,693,915,6,27,2,4,1,7,1,0,2,5,1663,15,2170
345,Dongdaemun,투표소,JA1,장안제1동제3투,"장안종합사회복지관(1층, 로비)",서울특별시 동대문구 한천로18길 48(장안동),3832,1311,573,681,7,16,2,1,1,16,6,1,0,3,1307,4,2521
346,Dongdaemun,투표소,JA1,장안제1동제4투,"군자초등학교(1층, 군자관)",서울특별시 동대문구 한천로6길 21(장안동),4210,1769,680,1011,3,28,1,2,0,17,4,1,0,6,1753,16,2441
347,Dongdaemun,투표소,JA1,장안제1동제5투,"장평중학교(1층, 과학실험실1)",서울특별시 동대문구 답십리로72길 158(장안동),2747,1251,505,707,4,13,1,3,0,6,1,0,0,4,1244,7,1496
348,Dongdaemun,투표소,JA1,장안제1동제6투,"안평초등학교(1층, 영어전용교실)",서울특별시 동대문구 장한로14길 61(장안동),3444,1463,587,821,3,22,0,2,1,10,7,1,0,3,1457,6,1981
349,Dongdaemun,투표소,JA1,장안제1동제7투,"동대문구민체육센터(2층, 대체육관)",서울특별시 동대문구 장안벚꽃로 67(장안동),2771,1516,514,965,3,11,2,0,0,6,3,0,0,4,1508,8,1255
350,Dongdaemun,투표소,JA1,장안제1동제8투,"장안현대홈타운복지관(1층,제1경로당)",서울특별시 동대문구 장안벚꽃로 107(장안동),3053,1876,657,1148,6,25,2,6,0,11,1,1,1,5,1863,13,1177
351,Dongdaemun,투표소,JA2,장안제2동제1투,"장안제2동주민센터(1층, 데크)",서울특별시 동대문구 사가정로 230-1(장안동),1842,760,294,442,4,5,0,0,0,6,2,0,0,3,756,4,1082
352,Dongdaemun,투표소,JA2,장안제2동제2투,장안현대아파트경로당(1층),서울특별시 동대문구 한천로 224(장안동),3076,1438,546,839,6,14,0,0,0,15,3,1,0,4,1428,10,1638
353,Dongdaemun,투표소,JA2,장안제2동제3투,더퍼스트데시앙아파트 경로당(1층),"서울특별시 동대문구 장한로27가길 37(장안동, 동대문 더퍼스트 데시앙)",2254,1033,374,630,2,12,0,2,0,2,7,0,0,2,1031,2,1221
354,Dongdaemun,투표소,JA2,장안제2동제4투,"구립장평경로당(1층, 로비)",서울특별시 동대문구 한천로28길 27(장안동),2562,1093,455,592,8,11,2,2,0,4,3,3,1,4,1085,8,1469
355,Dongdaemun,투표소,JA2,장안제2동제5투,장안어린이도서관(3층),서울특별시 동대문구 장한로26다길 10(장안동),4224,1730,751,912,8,15,2,7,0,9,6,0,1,5,1716,14,2494
356,Dongdaemun,투표소,JA2,장안제2동제6투,"서울장평초등학교(2층, 체육관)",서울특별시 동대문구 답십리로69길 27(장안동),2092,943,370,541,4,9,2,1,0,6,0,0,1,2,936,7,1149
357,Dongdaemun,투표소,JA2,장안제2동제7투,"삼성래미안2차아파트 관리사무소(지하1층, 탁구장)",서울특별시 동대문구 장안벚꽃로 167(장안동),3542,2005,771,1187,8,12,0,3,0,3,1,0,1,6,1992,13,1537
358,Dongdaemun,투표소,JA2,장안제2동제8투,장안현대힐스테이트아파트경로당(1층),서울특별시 동대문구 장안벚꽃로1길 7(장안동),2619,1322,509,772,6,12,0,2,0,6,1,0,0,2,1310,12,1297
359,Dongdaemun,투표소,CHRN,청량리동제1투,시립동대문청소년수련관(1층),서울특별시 동대문구 제기로33길 25(청량리동),2290,810,285,486,5,13,1,1,0,4,4,0,1,3,803,7,1480
360,Dongdaemun,투표소,CHRN,청량리동제2투,청량리동 한신1차아파트 경로당(1층),서울특별시 동대문구 제기로 129(청량리동),2738,1562,570,942,5,14,3,2,0,9,3,0,0,6,1554,8,1176
361,Dongdaemun,투표소,CHRN,청량리동제3투,"수림문화재단[(구)영화진흥위원회](1층, 로비)",서울특별시 동대문구 홍릉로 118(청량리동),1393,644,240,380,3,5,1,3,0,3,1,0,0,3,639,5,749
362,Dongdaemun,투표소,CHRN,청량리동제4투,홍릉문화복지센터내 치매지원센터(1층),서울특별시 동대문구 홍릉로 81(청량리동),2160,1039,341,658,3,18,1,1,0,3,1,1,0,1,1028,11,1121
363,Dongdaemun,투표소,CHRN,청량리동제5투,홍릉동부아파트 경로당(1층),"서울특별시 동대문구 홍릉로10길 48(청량리동, 홍릉동부아파트)",2517,1234,413,767,9,17,1,3,0,6,2,0,1,3,1222,12,1283
364,Dongdaemun,투표소,CHRN,청량리동제6투,"동대문세무서(지하1층, 회의실)",서울특별시 동대문구 약령시로 159(청량리동),3196,1780,461,1263,4,23,0,4,0,11,1,1,2,3,1773,7,1416
365,Dongdaemun,투표소,HK,회기동제1투,"서울청량초등학교(1층, 1-1반)",서울특별시 동대문구 회기로25길 31(회기동),2946,1138,336,712,18,10,4,4,0,22,3,0,0,10,1119,19,1808
366,Dongdaemun,투표소,HK,회기동제2투,"서울청량초등학교(1층, 1-3반)",서울특별시 동대문구 회기로25길 31(회기동),2331,993,306,624,17,5,2,3,0,13,4,1,0,9,984,9,1338
367,Dongdaemun,투표소,HK,회기동제3투,"서울 바이오허브 산업지원동(1층,로비)(구.농촌경제연구원)",서울특별시 동대문구 회기로 117-3(회기동),2120,876,306,501,12,8,1,3,0,13,3,2,0,9,858,18,1244
368,Dongdaemun,투표소,HK1,휘경제1동제1투,"휘경1동주민센터(4층, 강당)",서울특별시 동대문구 외대역동로6길 3(휘경동),3046,1417,465,889,5,15,2,3,0,10,6,0,0,5,1400,17,1629
369,Dongdaemun,투표소,HK1,휘경제1동제2투,"휘경메디컬프라자(3층, 구 휘경웨딩문화원)",서울특별시 동대문구 망우로 123(휘경동),2888,1317,448,807,6,16,2,4,0,15,8,0,0,4,1310,7,1571
370,Dongdaemun,투표소,HK1,휘경제1동제3투,"웨딩헤너스(1층, 카페)",서울특별시 동대문구 망우로 61(휘경동),3348,1220,434,683,21,8,1,6,0,19,11,0,0,16,1199,21,2128
371,Dongdaemun,투표소,HK2,휘경제2동제1투,"휘경2동주민센터(5층, 다목적 강당)",서울특별시 동대문구 한천로 329(휘경동),2247,919,306,571,6,8,2,3,0,4,3,1,0,3,907,12,1328
372,Dongdaemun,투표소,HK2,휘경제2동제2투,"휘경주공2단지아파트(1층, 주민복지관)",서울특별시 동대문구 한천로 248(휘경동),2344,1400,554,785,9,17,1,4,0,12,4,0,0,5,1391,9,944
373,Dongdaemun,투표소,HK2,휘경제2동제3투,"휘경중학교(2층, 체육관)",서울특별시 동대문구 망우로18나길 20(휘경동),3918,1725,578,1030,16,16,4,8,0,27,6,1,2,11,1699,26,2193
374,Dongdaemun,투표소,HK2,휘경제2동제4투,"휘경초등학교(1층, 드림카페)",서울특별시 동대문구 망우로6길 48(휘경동),3597,1576,538,941,11,23,4,11,0,12,4,0,1,9,1554,22,2021
375,Dongdaemun,투표소,HK2,휘경제2동제5투,"휘경주공1단지아파트 (1층, 경로당)",서울특별시 동대문구 한천로 248(휘경동),2844,1624,596,968,8,15,1,5,0,9,3,0,0,5,1610,14,1220
376,Dongdaemun,투표소,HK2,휘경제2동제6투,"휘경2동주민센터(지하, 주차장)",서울특별시 동대문구 한천로 329(휘경동),2352,1062,420,600,4,8,1,3,0,11,3,0,0,1,1051,11,1290
377,Dongdaemun,투표소,IM1,이문제1동제1투,"이문1동주민센터 (4층, 다목적강당)",서울특별시 동대문구 외대역동로 114-1(이문동),2246,888,319,527,2,11,2,0,0,7,3,1,1,3,876,12,1358
378,Dongdaemun,투표소,IM1,이문제1동제2투,"이문1동주민센터 (3층, 회의실)",서울특별시 동대문구 외대역동로 114-1(이문동),2144,909,352,513,4,13,3,1,1,7,4,0,0,5,903,6,1235
379,Dongdaemun,투표소,IM1,이문제1동제3투,이삭토스트 외대후문점 옆 건물 (1층),서울특별시 동대문구 천장산로 28(이문동),1993,1150,322,750,7,15,1,5,0,15,7,0,0,11,1133,17,843
380,Dongdaemun,투표소,IM1,이문제1동제4투,한국외국어대학원1층로비(문화센터105호 앞),서울특별시 동대문구 이문로 107(이문동),1835,723,238,429,11,6,3,2,0,13,4,0,0,10,716,7,1112
381,Dongdaemun,투표소,IM1,이문제1동제5투,래미안2차아파트경로당 (1층),"서울특별시 동대문구 이문로12길 3-10(이문동, 래미안이문2차아파트)",2493,1326,417,847,6,13,2,3,1,8,4,0,0,9,1310,16,1167
382,Dongdaemun,투표소,IM1,이문제1동제6투,"고황경로당 (1층, 이문청소년독서실)",서울특별시 동대문구 이문로9길 52(이문동),2603,1171,385,696,14,17,7,5,0,15,6,1,1,9,1156,15,1432
383,Dongdaemun,투표소,IM2,이문제2동제1투,"서울이문초등학교(1층, 로비)",서울특별시 동대문구 신이문로 16(이문동),3023,1196,418,690,12,16,2,4,0,21,6,1,3,8,1181,15,1827
384,Dongdaemun,투표소,IM2,이문제2동제2투,"서울이문초등학교(2층, 체육관)",서울특별시 동대문구 신이문로 16(이문동),2025,791,318,433,3,8,1,3,1,6,4,1,0,3,781,10,1234
385,Dongdaemun,투표소,IM2,이문제2동제3투,"이문체육문화센터(1층, 로비)",서울특별시 동대문구 한천로58길 81-49(이문동),2662,1250,473,726,7,14,0,2,0,10,6,1,0,3,1242,8,1412
386,Dongdaemun,투표소,IM2,이문제2동제4투,"이문체육문화센터(1층, 체육관)",서울특별시 동대문구 한천로58길 81-49(이문동),2768,1651,634,949,7,22,7,1,1,10,3,0,1,7,1642,9,1117
387,Dongdaemun,투표소,IM2,이문제2동제5투,"이문e편한세상아파트(1층, 경로당)",서울특별시 동대문구 한천로63길 10(이문동),2750,1548,589,903,6,14,1,2,0,6,4,1,2,6,1534,14,1202
388,Jungnang,투표소,MMB,면목본동제1투,"면목본동주민센터(3층, 세미나실)",서울특별시 중랑구 면목로 397(면목동),4125,1449,535,849,9,27,1,0,0,6,4,0,1,3,1435,14,2676
389,Jungnang,투표소,MMB,면목본동제2투,"면목초등학교(2층, 미술실)",서울특별시 중랑구 면목로 434(면목동),3434,1348,536,735,5,16,5,6,2,13,9,1,2,6,1336,12,2086
390,Jungnang,투표소,MMB,면목본동제3투,"면동초등학교(2층, 구 도서실)",서울특별시 중랑구 면목로57길 32(면목동),3697,1364,533,745,8,34,2,7,0,7,7,1,1,6,1351,13,2333
391,Jungnang,투표소,MMB,면목본동제4투,"면목초등학교(1층, 보건교육실)",서울특별시 중랑구 면목로 434(면목동),3300,1129,472,613,5,8,0,2,1,9,6,2,0,4,1122,7,2171
392,Jungnang,투표소,MMB,면목본동제5투,"중랑구건강가정다문화가족지원센터(2층, 교육실)",서울특별시 중랑구 용마산로 369(면목동),3313,1189,479,649,5,13,2,3,0,12,8,1,1,1,1174,15,2124
393,Jungnang,투표소,MMB,면목본동제6투,"면목본동 경로당(1층, 할머니방)",서울특별시 중랑구 면목로64길 37-4(면목동),3835,1235,511,660,8,16,4,2,0,7,7,0,0,10,1225,10,2600
394,Jungnang,투표소,MMB,면목본동제7투,"면목본동주민센터(2층, 문화교실)",서울특별시 중랑구 면목로 397(면목동),3366,1172,467,656,5,16,2,4,0,4,3,0,0,4,1161,11,2194
395,Jungnang,투표소,MM2,면목제2동제1투,"중목초등학교(1층, 보건영양교육실)",서울특별시 중랑구 동일로 665(면목동),3885,1244,497,695,4,17,1,2,0,11,5,1,0,1,1234,10,2641
396,Jungnang,투표소,MM2,면목제2동제2투,"중랑초등학교(1층, 표현실)",서울특별시 중랑구 봉우재로6길 26(면목동),2947,1299,490,766,3,11,1,6,0,7,4,0,0,1,1289,10,1648
397,Jungnang,투표소,MM2,면목제2동제3투,"중랑초등학교(1층, 늘품실)",서울특별시 중랑구 봉우재로6길 26(면목동),3892,1400,583,759,5,16,1,5,0,10,5,0,1,3,1388,12,2492
398,Jungnang,투표소,MM2,면목제2동제4투,"중목초등학교(1층, 돌봄교실2)",서울특별시 중랑구 동일로 665(면목동),3527,1315,540,710,6,16,4,3,0,15,3,1,0,6,1304,11,2212
399,Jungnang,투표소,MM2,면목제2동제5투,"면목제2동 체육관(4층, 체력단련실 로비)",서울특별시 중랑구 겸재로23길 27(면목동),3467,1335,565,719,5,17,1,5,0,11,0,0,1,7,1331,4,2132
400,Jungnang,투표소,MM3·8,면목제3·8동제1투,"면목제3·8동주민센터(5층, 대회의실)",서울특별시 중랑구 사가정로51길 48(면목동),2997,1078,427,618,3,11,0,4,0,3,2,0,0,3,1071,7,1919
401,Jungnang,투표소,MM3·8,면목제3·8동제2투,까치공원 경로당(1층),서울특별시 중랑구 사가정로49길 56(면목동),2501,1012,430,537,6,17,0,1,0,7,4,0,0,4,1006,6,1489
402,Jungnang,투표소,MM3·8,면목제3·8동제3투,용마산 경로당(1층),서울특별시 중랑구 용마산로 327(면목동),2694,949,422,482,4,12,1,1,1,7,2,0,1,3,936,13,1745
403,Jungnang,투표소,MM3·8,면목제3·8동제4투,"면목중학교(1층, 체육관)",서울특별시 중랑구 용마산로70길 37(면목동),2617,1046,427,584,2,9,1,4,0,5,2,1,1,2,1038,8,1571
404,Jungnang,투표소,MM3·8,면목제3·8동제5투,"중화중학교 늘품관(1층, 다목적실)",서울특별시 중랑구 용마산로 364(면목동),2621,1201,491,675,4,10,1,1,0,6,1,0,0,3,1192,9,1420
405,Jungnang,투표소,MM3·8,면목제3·8동제6투,"용마문화복지센터(지하1층, 생활체육실)",서울특별시 중랑구 용마산로 393(면목동),2592,1056,374,637,4,18,1,3,0,7,2,2,0,1,1049,7,1536
406,Jungnang,투표소,MM3·8,면목제3·8동제7투,"구립용마경로복지센터(3층, 프로그램실)",서울특별시 중랑구 용마산로94길 98(면목동),2649,1249,487,714,8,11,0,1,0,4,2,0,1,1,1229,20,1400
407,Jungnang,투표소,MM4,면목제4동제1투,"중랑구민회관[1층, 소회의실(웨딩홀)]",서울특별시 중랑구 면목로 238(면목동),2501,946,356,558,1,8,1,0,0,8,1,0,1,5,939,7,1555
408,Jungnang,투표소,MM4,면목제4동제2투,"중곡초등학교(1층, 돌봄교실4)",서울특별시 중랑구 면목로23길 20(면목동),3079,1288,526,707,4,17,0,4,0,10,2,3,0,5,1278,10,1791
409,Jungnang,투표소,MM4,면목제4동제3투,"서울특별시교육청 과학전시관 동부분관(1층, 도전활동실)",서울특별시 중랑구 면목로23길 20(면목동),2727,1147,495,594,8,14,0,5,1,12,3,1,0,4,1137,10,1580
410,Jungnang,투표소,MM4,면목제4동제4투,"시립중랑청소년센터(4층, 무한지대3)",서울특별시 중랑구 용마산로 217(면목동),2568,1082,446,584,3,18,7,7,0,6,0,2,0,5,1078,4,1486
411,Jungnang,투표소,MM4,면목제4동제5투,"시립중랑청소년센터(2층, 강당)",서울특별시 중랑구 용마산로 217(면목동),2473,1056,413,602,3,8,4,5,0,3,2,0,0,2,1042,14,1417
412,Jungnang,투표소,MM5,면목제5동제1투,"면목제5동주민센터(2층, 작은도서관)",서울특별시 중랑구 동일로 619(면목동),3250,1229,545,640,4,17,3,2,0,12,0,0,0,2,1225,4,2021
413,Jungnang,투표소,MM5,면목제5동제2투,"면목제5동주민센터(3층, 대강당)",서울특별시 중랑구 동일로 619(면목동),3272,1186,534,603,4,11,2,3,0,5,7,0,0,9,1178,8,2086
414,Jungnang,투표소,MM5,면목제5동제3투,"사가정센트럴아이파크아파트(110동 1층, 경로당)","서울특별시 중랑구 동일로92길 40(면목동, 사가정센트럴아이파크)",3339,1933,775,1088,9,23,2,7,0,10,2,0,0,7,1923,10,1406
415,Jungnang,투표소,MM7,면목제7동제1투,"면목제7동주민센터(2층, 프로그램실)",서울특별시 중랑구 면목로 298(면목동),3081,1120,484,575,7,16,2,2,0,10,6,1,0,1,1104,16,1961
416,Jungnang,투표소,MM7,면목제7동제2투,MG새마을금고 용마점(지하1층),서울특별시 중랑구 면목로 299(면목동),3229,1225,458,722,2,17,0,4,0,5,1,1,0,5,1215,10,2004
417,Jungnang,투표소,MM7,면목제7동제3투,"면남초등학교(1층, 꿈나눔터 체육관)",서울특별시 중랑구 면목로30나길 38(면목동),2685,908,359,515,7,4,1,0,0,9,4,1,0,4,904,4,1777
418,Jungnang,투표소,MM7,면목제7동제4투,"면남초등학교(1층, 음악놀이실)",서울특별시 중랑구 면목로30나길 38(면목동),2935,1231,423,762,5,13,3,2,0,9,1,0,0,4,1222,9,1704
419,Jungnang,투표소,MM7,면목제7동제5투,"중랑문화체육관(1층, 로비)",서울특별시 중랑구 사가정로72길 47(면목동),3187,1463,568,832,5,27,3,5,1,8,3,0,1,3,1456,7,1724
420,Jungnang,투표소,SB1,상봉제1동제1투,"대한노인회 중랑구지회(1층, 문화교실)",서울특별시 중랑구 봉화산로43길 9(상봉동),4285,1413,606,747,6,18,0,3,0,13,4,0,3,3,1403,10,2872
421,Jungnang,투표소,SB1,상봉제1동제2투,"건영2차아파트 관리사무소 경로당(1층, 할머니방)","서울특별시 중랑구 신내로7나길 24(상봉동, 건영2차아파트)",3762,1957,781,1109,5,17,1,6,0,14,5,0,0,7,1945,12,1805
422,Jungnang,투표소,SB1,상봉제1동제3투,"상봉중학교(1층, 기술실)",서울특별시 중랑구 상봉중앙로8나길 28(상봉동),3648,1706,660,962,7,19,0,3,0,15,10,3,0,8,1687,19,1942
423,Jungnang,투표소,SB1,상봉제1동제4투,"신내종합사회복지관(2층, 강당)",서울특별시 중랑구 봉화산로 165(상봉동) 신내아파트12단지,3344,1558,651,835,6,20,3,3,0,10,8,0,0,5,1541,17,1786
424,Jungnang,투표소,SB1,상봉제1동제5투,"상봉프레미어스엠코 (지하2층, 중랑아트센터 회의실)","서울특별시 중랑구 망우로 353(상봉동, 상봉 프레미어스 엠코)",1565,859,271,549,8,9,2,2,0,4,0,0,1,4,850,9,706
425,Jungnang,투표소,SB2,상봉제2동제1투,"상봉제2동주민센터(2층, 대강당)",서울특별시 중랑구 동일로114길 10(상봉동),3533,1183,482,638,3,26,1,2,0,10,3,0,1,4,1170,13,2350
426,Jungnang,투표소,SB2,상봉제2동제2투,봉황구립경로당(1층),서울특별시 중랑구 봉우재로33길 55-10(상봉동),4669,1841,637,1110,13,20,1,1,0,27,7,0,1,4,1821,20,2828
427,Jungnang,투표소,SB2,상봉제2동제3투,"상봉제2동주민센터(1층, 로비)",서울특별시 중랑구 동일로114길 10(상봉동),3774,1236,531,620,4,11,2,4,0,27,6,5,0,7,1217,19,2538
428,Jungnang,투표소,SB2,상봉제2동제4투,"서울특별시체육회(1층, 대회의실)",서울특별시 중랑구 망우로 182(상봉동),3070,1068,448,570,8,16,2,0,0,9,5,0,0,3,1061,7,2002
429,Jungnang,투표소,JH1,중화제1동제1투,"중화제1동주민센터(3층, 생활체육실)",서울특별시 중랑구 동일로134길 17(중화동),3860,1406,555,780,5,28,2,5,1,8,2,1,0,4,1391,15,2454
430,Jungnang,투표소,JH1,중화제1동제2투,"중흥초등학교(1층, 보건교육실)",서울특별시 중랑구 봉화산로 82(중화동),3566,1489,603,791,10,38,3,4,1,13,8,0,0,11,1482,7,2077
431,Jungnang,투표소,JH1,중화제1동제3투,"묵동초등학교(1층, 연수실)",서울특별시 중랑구 동일로138길 27(중화동),3756,1535,604,861,5,26,5,4,0,11,4,1,0,7,1528,7,2221
432,Jungnang,투표소,JH1,중화제1동제4투,"장안중학교(1층, 탁구장)",서울특별시 중랑구 동일로 780(중화동),2568,1201,451,707,0,22,0,3,0,4,3,0,1,3,1194,7,1367
433,Jungnang,투표소,JH2,중화제2동제1투,"중화2동주민센터(7층, 새마을문고)",서울특별시 중랑구 동일로129길 1(중화동),2900,1083,440,599,7,12,1,3,0,7,2,0,0,3,1074,9,1817
434,Jungnang,투표소,JH2,중화제2동제2투,봉화경로당(1층),서울특별시 중랑구 봉화산로3길 40-5(중화동),3654,1312,541,697,7,33,0,5,0,11,1,0,1,3,1299,13,2342
435,Jungnang,투표소,JH2,중화제2동제3투,"중화문화복지센터(4층, 마루방)",서울특별시 중랑구 중랑역로3길 28(중화동),3514,1385,526,778,9,23,4,6,0,17,3,2,1,4,1373,12,2129
436,Jungnang,투표소,JH2,중화제2동제4투,백학경로당(1층),서울특별시 중랑구 중랑천로20길 6-14(중화동),3252,1275,588,617,9,19,1,2,0,9,6,1,0,7,1259,16,1977
437,Jungnang,투표소,JH2,중화제2동제5투,학구경로당(1층),서울특별시 중랑구 동일로123길 69-5(중화동),2808,1161,487,621,6,12,3,6,0,5,3,0,0,7,1150,11,1647
438,Jungnang,투표소,JH2,중화제2동제6투,중랑구사회적경제지원센터(1층),서울특별시 중랑구 중랑역로4길 29(중화동),2920,1078,406,607,7,29,0,3,0,9,4,1,1,3,1070,8,1842
439,Jungnang,투표소,M1,묵제1동제1투,"위더스중랑(1층, 로비)",서울특별시 중랑구 동일로 922(묵동),3170,1533,553,913,15,13,1,6,1,15,1,1,1,4,1524,9,1637
440,Jungnang,투표소,M1,묵제1동제2투,"묵1동자치회관별관(3층, 생활체육실)",서울특별시 중랑구 공릉로12가길 6(묵동),3000,1315,556,702,2,18,3,3,0,11,3,0,0,6,1304,11,1685
441,Jungnang,투표소,M1,묵제1동제3투,"원묵고등학교(1층,향학당)",서울특별시 중랑구 숙선옹주로 82(묵동),2723,1642,479,1096,12,13,1,4,1,15,3,0,0,3,1627,15,1081
442,Jungnang,투표소,M1,묵제1동제4투,"원묵초등학교(1층, 6-1교실)",서울특별시 중랑구 숙선옹주로 109(묵동),3531,1624,649,899,6,28,2,5,0,12,4,0,0,6,1611,13,1907
443,Jungnang,투표소,M1,묵제1동제5투,"한국전력동부지점(1층, 로비)",서울특별시 중랑구 동일로 862(묵동),4331,1892,748,1074,16,23,0,2,1,10,4,0,0,5,1883,9,2439
444,Jungnang,투표소,M1,묵제1동제6투,묵1동 구립경로당(1층),서울특별시 중랑구 공릉로2라길 26(묵동),3574,1801,672,1063,7,25,1,4,0,13,2,1,0,1,1789,12,1773
445,Jungnang,투표소,M1,묵제1동제7투,"묵1동주민센터(2층, 회의실)",서울특별시 중랑구 공릉로2가길 5(묵동),3241,1163,482,593,8,19,3,3,0,23,7,0,0,7,1145,18,2078
446,Jungnang,투표소,M2,묵제2동제1투,"묵현초등학교(1층, 돌봄교실3)",서울특별시 중랑구 동일로157길 75(묵동),3492,1682,626,994,5,19,3,3,0,6,7,1,0,7,1671,11,1810
447,Jungnang,투표소,M2,묵제2동제2투,"묵현초등학교(1층, 학습도움실1)",서울특별시 중랑구 동일로157길 75(묵동),3392,1342,553,727,9,16,2,3,0,9,6,1,0,7,1333,9,2050
448,Jungnang,투표소,M2,묵제2동제3투,"묵현초등학교(1층, 학습도움실2)",서울특별시 중랑구 동일로157길 75(묵동),3445,1398,508,825,6,16,1,6,0,16,1,1,0,4,1384,14,2047
449,Jungnang,투표소,M2,묵제2동제4투,"신묵초등학교(1층, 시청각실)",서울특별시 중랑구 동일로149길 46(묵동),3638,1394,585,747,6,32,2,0,0,4,3,0,1,2,1382,12,2244
450,Jungnang,투표소,MWB,망우본동제1투,"망우본동주민센터(2층, 다목적실)",서울특별시 중랑구 망우로67길 10(망우동),3043,1142,388,711,7,19,0,3,0,1,5,2,0,2,1138,4,1901
451,Jungnang,투표소,MWB,망우본동제2투,"동원초등학교(1층, 다목적실)",서울특별시 중랑구 송림길 114(망우동),3150,1332,414,862,7,16,2,4,2,10,2,1,1,1,1322,10,1818
452,Jungnang,투표소,MWB,망우본동제3투,"동원중학교 (1층, 체육교과(보건)교육실)",서울특별시 중랑구 양원역로 32(망우동),2716,1254,445,766,4,15,1,4,0,5,3,0,2,1,1246,8,1462
453,Jungnang,투표소,MWB,망우본동제4투,"망우초등학교(1층, 건강자람터)",서울특별시 중랑구 망우로72길 49(망우동),2503,1115,380,696,2,13,3,1,0,2,3,2,1,1,1104,11,1388
454,Jungnang,투표소,MWB,망우본동제5투,"망우초등학교(1층, 체력단련실)",서울특별시 중랑구 망우로72길 49(망우동),2736,1121,402,676,6,17,2,1,0,6,1,0,0,2,1113,8,1615
455,Jungnang,투표소,MWB,망우본동제6투,"우림시장진흥조합사무실(1층,회의실)",서울특별시 중랑구 망우로62길 52-4(망우동),3760,1527,583,884,3,20,1,2,0,17,8,0,1,3,1522,5,2233
456,Jungnang,투표소,MWB,망우본동제7투,"동국빌딩(2층, 한국마사회)",서울특별시 중랑구 망우로 390(망우동),4230,1706,641,984,8,24,2,4,0,15,7,1,1,8,1695,11,2524
457,Jungnang,투표소,MW3,망우제3동제1투,"혜원여자중학교(체육관, 1층)",서울특별시 중랑구 봉우재로58길 39(망우동),2690,912,351,519,3,15,0,3,0,10,3,1,0,1,906,6,1778
458,Jungnang,투표소,MW3,망우제3동제2투,"면일초등학교(면일체육문화센터, 3층 다목적체육관)",서울특별시 중랑구 용마산로100길 13(망우동),3384,1277,470,740,8,24,0,1,0,9,4,1,1,5,1263,14,2107
459,Jungnang,투표소,MW3,망우제3동제3투,"면일초등학교(면일체육문화센터, 3층 다목적체육관)",서울특별시 중랑구 용마산로100길 13(망우동),3637,1406,594,742,8,32,1,1,0,7,2,1,0,3,1391,15,2231
460,Jungnang,투표소,MW3,망우제3동제4투,"혜원여자중학교(체육관, 1층)",서울특별시 중랑구 봉우재로58길 39(망우동),2735,1013,369,601,3,10,2,2,0,6,2,1,0,6,1002,11,1722
461,Jungnang,투표소,SN1,신내제1동제1투,"신내1동주민센터(3층, 강당)",서울특별시 중랑구 용마산로129나길 35(신내동),2985,1369,489,830,4,15,0,2,0,12,1,1,2,5,1361,8,1616
462,Jungnang,투표소,SN1,신내제1동제2투,동성1·2차아파트 경로당(2층),"서울특별시 중랑구 신내로 128(신내동, 동성아파트)",2505,1410,514,841,7,12,2,2,1,9,7,1,0,5,1401,9,1095
463,Jungnang,투표소,SN1,신내제1동제3투,"원광장애인종합복지관(5층, 체육관)",서울특별시 중랑구 신내로 56(신내동),2594,1230,491,682,4,19,2,4,0,14,2,0,0,3,1221,9,1364
464,Jungnang,투표소,SN1,신내제1동제4투,"데시앙아파트 다목적실(1층, 다목적실)","서울특별시 중랑구 용마산로 669(신내동, 신내데시앙아파트)",3929,1954,834,1048,11,19,1,4,0,8,8,1,0,8,1942,12,1975
465,Jungnang,투표소,SN1,신내제1동제5투,"신내초등학교(1층, 1-1반)",서울특별시 중랑구 용마산로125나길 22(신내동),2834,1350,509,797,1,14,2,3,2,5,3,1,0,2,1339,11,1484
466,Jungnang,투표소,SN1,신내제1동제6투,"신내경로복지센터(4층, 다목적강당)",서울특별시 중랑구 망우로65길 20(신내동),2187,924,303,595,2,9,0,1,0,5,4,0,0,2,921,3,1263
467,Jungnang,투표소,SN1,신내제1동제7투,"동성3차아파트관리사무소(2층, 입주자대표회의실)","서울특별시 중랑구 신내로 110(신내동, 동성아파트)",2719,1427,528,847,6,11,1,2,0,10,4,1,0,3,1413,14,1292
468,Jungnang,투표소,SN1,신내제1동제8투,"새솔초등학교(1층, 1-4반)",서울특별시 중랑구 신내역로1길 164(신내동),3563,1938,877,981,12,26,3,6,0,9,5,1,0,7,1927,11,1625
469,Jungnang,투표소,SN1,신내제1동제9투,"새솔초등학교(1층, 2-1반)",서울특별시 중랑구 신내역로1길 164(신내동),2925,1508,694,741,5,26,1,3,0,13,7,1,0,4,1495,13,1417
470,Jungnang,투표소,SN2,신내제2동제1투,"신내2동주민센터(4층, 자원봉사센터 회의실)",서울특별시 중랑구 봉화산로 190(신내동),2600,1175,461,663,8,14,1,1,0,13,3,1,0,3,1168,7,1425
471,Jungnang,투표소,SN2,신내제2동제2투,"6단지 관리사무소 (1층, 6단지경로당 할머니방)","서울특별시 중랑구 신내로19길 42(신내동, 신내6단지신내아파트)",3022,1677,740,851,8,25,3,5,0,15,1,2,0,13,1663,14,1345
472,Jungnang,투표소,SN2,신내제2동제3투,"봉화초등학교(1층, 보건교육실)",서울특별시 중랑구 신내로15길 110(신내동),3139,1706,613,1022,12,21,1,5,0,15,2,2,1,4,1698,8,1433
473,Jungnang,투표소,SN2,신내제2동제4투,9단지 관리사무소 로비(1층),"서울특별시 중랑구 신내로 133(신내동, 신내9단지신내아파트 관리사무소)",3028,1552,642,853,8,17,1,5,0,14,2,0,0,3,1545,7,1476
474,Jungnang,투표소,SN2,신내제2동제5투,"11단지관리사무소 (1층, 경로당)","서울특별시 중랑구 봉화산로 193(신내동, 신내대명아파트)",2682,1322,522,741,6,14,3,4,0,8,6,3,0,6,1313,9,1360
475,Seongbuk,투표소,SB,성북동제1투,"성북동주민센터(5층, 강당)",서울특별시 성북구 성북로 37(성북동1가),3231,1533,642,780,12,20,9,6,1,24,10,0,0,14,1518,15,1698
476,Seongbuk,투표소,SB,성북동제2투,"성북초등학교 향빛관(1층, 다목적실)",서울특별시 성북구 성북로 102-10(성북동),3047,1298,463,781,9,5,2,3,1,7,4,2,0,12,1289,9,1749
477,Seongbuk,투표소,SB,성북동제3투,성북글로벌빌리지센터(1층),서울특별시 성북구 성북로 134(성북동),2154,1122,343,736,5,7,5,2,0,7,0,0,0,11,1116,6,1032
478,Seongbuk,투표소,SB,성북동제4투,"성북문화원(1층, 소강당)",서울특별시 성북구 성북로4길 13-8(동소문동1가),2646,1084,418,597,16,16,1,2,0,13,2,0,1,8,1074,10,1562
479,Seongbuk,투표소,SS,삼선동제1투,"삼선동주민센터(2층, 회의실)",서울특별시 성북구 보문로 190(삼선동4가),3980,1668,575,989,16,23,1,2,0,32,2,2,0,11,1653,15,2312
480,Seongbuk,투표소,SS,삼선동제2투,"성북정보화센터(2층, 청소년공부방)",서울특별시 성북구 삼선교로4길 47-1(삼선동1가),2709,1191,528,603,6,18,2,3,1,10,3,0,1,10,1185,6,1518
481,Seongbuk,투표소,SS,삼선동제3투,"한성여자고등학교(지하1층, 탁구교육실)",서울특별시 성북구 삼선교로16길 117(삼선동2가),2499,1316,573,686,9,14,3,4,0,11,1,1,2,5,1309,7,1183
482,Seongbuk,투표소,SS,삼선동제4투,삼선초등학교 체육관(1층),서울특별시 성북구 보문로29길 106(삼선동3가),3535,1613,627,919,11,13,2,6,0,12,6,0,0,8,1604,9,1922
483,Seongbuk,투표소,SS,삼선동제5투,경동고등학교 체육관(1층),서울특별시 성북구 보문로29길 49(삼선동3가),3345,1156,457,618,8,20,0,5,0,23,5,0,0,4,1140,16,2189
484,Seongbuk,투표소,DS,동선동제1투,"동선동주민센터(3층, 대강당)",서울특별시 성북구 동소문로26길 27(동선동3가),1988,763,290,402,8,8,2,3,0,29,5,0,0,7,754,9,1225
485,Seongbuk,투표소,DS,동선동제2투,"성신여대 미디어정보관(1층, 평생교육원 102호)",서울특별시 성북구 보문로30길 50(동선동2가),3138,1267,501,581,18,19,2,4,0,103,5,0,0,19,1252,15,1871
486,Seongbuk,투표소,DS,동선동제3투,성북시각장애인복지관(4층),서울특별시 성북구 동소문로25가길 20(동선동4가),2635,1143,443,619,9,12,5,4,0,23,9,0,0,12,1136,7,1492
487,Seongbuk,투표소,DS,동선동제4투,동선보건지소(4층),서울특별시 성북구 아리랑로3길 8(동소문동6가),3523,1542,580,824,26,13,0,6,1,42,11,0,1,16,1520,22,1981
488,Seongbuk,투표소,DA1,돈암제1동제1투,"범양아파트(지하1층, 주차장)",서울특별시 성북구 정릉로 402-16(돈암동),2275,1183,448,661,7,26,3,2,0,7,4,0,0,12,1170,13,1092
489,Seongbuk,투표소,DA1,돈암제1동제2투,"동부센트레빌아파트(지하5층, 주차장)",서울특별시 성북구 정릉로 388(돈암동),2248,1176,415,712,6,11,0,4,0,13,3,0,0,5,1169,7,1072
490,Seongbuk,투표소,DA1,돈암제1동제3투,"삼성아파트 경로당(1층, 할머니방)",서울특별시 성북구 동소문로34길 24(돈암동),3218,1877,692,1098,14,20,2,3,0,16,8,0,1,8,1862,15,1341
491,Seongbuk,투표소,DA1,돈암제1동제4투,"고명중학교(1층, 문화실)",서울특별시 성북구 북악산로 870(돈암동),2246,1000,395,559,7,13,2,0,0,10,2,1,0,2,991,9,1246
492,Seongbuk,투표소,DA2,돈암제2동제1투,"돈암2동주민센터(2층, 다목적실)",서울특별시 성북구 흥천사길 7(돈암동),3683,1711,628,1010,12,14,6,7,0,8,3,2,1,7,1698,13,1972
493,Seongbuk,투표소,DA2,돈암제2동제2투,한진경로당(1층),서울특별시 성북구 성북로4길 52(돈암동),2741,1425,485,888,7,17,0,4,0,9,1,0,0,5,1416,9,1316
494,Seongbuk,투표소,DA2,돈암제2동제3투,"아리랑시네센터(지하1층, 세미나실)",서울특별시 성북구 아리랑로 82(돈암동),2892,1384,629,703,7,16,1,3,0,8,2,1,0,4,1374,10,1508
495,Seongbuk,투표소,DA2,돈암제2동제4투,한신팔각정노인정(1층),서울특별시 성북구 성북로4길 52(돈암동),3066,1711,533,1120,5,13,0,2,0,10,4,1,1,8,1697,14,1355
496,Seongbuk,투표소,DA2,돈암제2동제5투,"성북구민회관(1층, 강당 로비)",서울특별시 성북구 성북로4길 177(돈암2동),2543,1324,442,824,9,16,0,4,0,10,2,0,0,4,1311,13,1219
497,Seongbuk,투표소,AA,안암동제1투,"안암동주민센터(1층, 주민모임방)",서울특별시 성북구 고려대로 16(안암동2가),2250,867,302,505,11,14,2,3,0,15,2,0,0,4,858,9,1383
498,Seongbuk,투표소,AA,안암동제2투,대한노인회 성북구지회(1층),서울특별시 성북구 안암로 79(안암동5가),2781,1201,310,796,13,13,1,8,2,10,7,1,0,15,1176,25,1580
499,Seongbuk,투표소,AA,안암동제3투,안암초등학교 안암꿈마루(2층),서울특별시 성북구 고려대로7가길 39(안암동2가),3459,1444,511,810,15,12,4,4,1,40,7,0,1,13,1418,26,2015
500,Seongbuk,투표소,AA,안암동제4투,삼익아파트 실내체육관(1층),서울특별시 성북구 안암로9길 30(안암동3가),2549,1173,381,730,8,16,3,4,0,5,2,0,0,7,1156,17,1376
501,Seongbuk,투표소,BM,보문동제1투,"보문동주민센터(2층, 북카페)",서울특별시 성북구 안암로3길 35(보문동7가),3727,1318,537,719,7,8,1,5,0,12,10,0,1,9,1309,9,2409
502,Seongbuk,투표소,BM,보문동제2투,서울성북육아종합지원센터(1층),서울특별시 성북구 지봉로24길 26(보문동5가),2800,1154,442,639,11,13,1,7,1,18,3,0,0,9,1144,10,1646
503,Seongbuk,투표소,BM,보문동제3투,"동신초등학교(4층, 체육관)",서울특별시 성북구 보문사길 50(보문동3가),3972,1633,644,920,9,12,0,6,0,13,8,3,0,4,1619,14,2339
504,Seongbuk,투표소,JR1,정릉제1동제1투,"정릉1동주민센터(3층, 강당)",서울특별시 성북구 정릉로38마길 33(정릉동),2823,1335,515,758,4,17,1,4,0,11,5,1,0,7,1323,12,1488
505,Seongbuk,투표소,JR1,정릉제1동제2투,"정릉1동커뮤니티센터(2층, 커뮤니티홀)",서울특별시 성북구 정릉로38가길 6(정릉동),3076,1335,527,745,11,15,2,4,0,13,4,0,1,5,1327,8,1741
506,Seongbuk,투표소,JR1,정릉제1동제3투,"태영아파트(102동, 지하주차장)",서울특별시 성북구 서경로 28(정릉동),2922,1462,608,797,5,18,2,6,0,12,1,0,1,6,1456,6,1460
507,Seongbuk,투표소,JR1,정릉제1동제4투,"경남아파트 관리동(1층, 입주자대표회의실)",서울특별시 성북구 정릉로 305(정릉동),2636,1404,521,827,9,15,1,3,0,6,1,0,0,10,1393,11,1232
508,Seongbuk,투표소,JR2,정릉제2동제1투,"성북아동청소년센터(1층, 청소년휴카페)",서울특별시 성북구 정릉로 242(정릉동),3636,1792,693,1004,10,37,6,3,0,12,6,1,0,5,1777,15,1844
509,Seongbuk,투표소,JR2,정릉제2동제2투,"숭덕초등학교(1층, 시청각실 앞 복도)",서울특별시 성북구 정릉로 279(정릉동),3794,1485,605,808,9,17,0,5,1,19,2,1,3,7,1477,8,2309
510,Seongbuk,투표소,JR2,정릉제2동제3투,"숭덕초등학교(1층, 보건교육실)",서울특별시 성북구 정릉로 279(정릉동),3493,1418,525,836,9,21,1,2,0,8,3,1,1,3,1410,8,2075
511,Seongbuk,투표소,JR2,정릉제2동제4투,"우정에쉐르아파트 102동(지하1층, 북카페)",서울특별시 성북구 북악산로 742-12(정릉동),3832,1679,667,934,11,22,4,3,0,9,4,2,1,10,1667,12,2153
512,Seongbuk,투표소,JR3,정릉제3동제1투,"정릉3동주민센터(2층, 회의실)",서울특별시 성북구 솔샘로1길 6-3(정릉동),2756,985,362,557,6,24,1,2,0,6,4,0,0,6,968,17,1771
513,Seongbuk,투표소,JR3,정릉제3동제2투,산일경로당(1층),서울특별시 성북구 보국문로29가길 15(정릉동),1256,474,163,294,1,7,0,2,0,1,1,0,1,1,471,3,782
514,Seongbuk,투표소,JR3,정릉제3동제3투,"정릉실버복지센터(2층, 프로그램실)",서울특별시 성북구 솔샘로 8(정릉동),3694,1460,553,817,12,28,5,2,0,16,5,3,0,6,1447,13,2234
515,Seongbuk,투표소,JR3,정릉제3동제4투,"북악중학교 정보동(1층, 로비)",서울특별시 성북구 정릉로12길 41(정릉동),2513,906,294,559,5,21,1,3,0,11,2,1,0,3,900,6,1607
516,Seongbuk,투표소,JR4,정릉제4동제1투,정릉대우아파트 경로당(1층),서울특별시 성북구 보국문로30길 15(정릉동),2830,1370,520,795,9,13,1,4,0,11,3,0,0,10,1366,4,1460
517,Seongbuk,투표소,JR4,정릉제4동제2투,"정릉4동주민센터(3층, 강당)",서울특별시 성북구 보국문로 106-1(정릉동),4116,1505,605,841,10,15,1,3,0,7,4,0,0,7,1493,12,2611
518,Seongbuk,투표소,JR4,정릉제4동제3투,성북구청소년문화의집(2층),서울특별시 성북구 솔샘로 107(정릉동),3268,1354,557,751,6,12,1,2,0,5,4,0,0,11,1349,5,1914
519,Seongbuk,투표소,JR4,정릉제4동제4투,"북한산국립공원 탐방안내소(1층, 별관)",서울특별시 성북구 보국문로 215(정릉동),2249,1072,405,617,7,13,1,6,0,10,1,0,0,5,1065,7,1177
520,Seongbuk,투표소,JR4,정릉제4동제5투,정릉풍림아이원아파트 경로당(1층),서울특별시 성북구 솔샘로25길 28(정릉동),3938,2019,842,1094,7,19,1,10,0,12,8,0,1,4,1998,21,1919
521,Seongbuk,투표소,KE1,길음제1동제1투,"길음뉴타운4단지 426동(지하1층, 주차장)",서울특별시 성북구 길음로 118(길음동),3048,1698,644,988,12,10,2,6,0,8,2,0,1,11,1684,14,1350
522,Seongbuk,투표소,KE1,길음제1동제2투,길음뉴타운2단지 대우푸르지오아파트 경로당(1층),서울특별시 성북구 길음로 119(길음동),3547,1851,782,1017,7,15,0,5,0,10,3,2,0,4,1845,6,1696
523,Seongbuk,투표소,KE1,길음제1동제3투,"길음1동주민센터(4층, 강당)",서울특별시 성북구 길음로 92(길음동),3371,1484,532,893,7,8,3,6,0,13,1,0,1,10,1474,10,1887
524,Seongbuk,투표소,KE1,길음제1동제4투,"길음뉴타운6단지 608동(1층, 주차장)",서울특별시 성북구 길음로 16(길음동),3421,1726,573,1078,15,15,2,5,0,13,4,0,0,10,1715,11,1695
525,Seongbuk,투표소,KE1,길음제1동제5투,"길음뉴타운8단지 814동 커뮤니티센터(지하1층, 대연회장)",서울특별시 성북구 길음로 33(길음동),2989,1643,613,980,9,6,1,6,0,11,3,0,2,8,1639,4,1346
526,Seongbuk,투표소,KE1,길음제1동제6투,"래미안아파트 길음1차 108동(1층, 입주자대표회의실)",서울특별시 성북구 길음로9길 40(길음동),2100,1221,494,686,6,7,0,1,0,15,1,0,0,6,1216,5,879
527,Seongbuk,투표소,KE1,길음제1동제7투,"길음뉴타운9단지 909동(지하1층, 커뮤니티센터)",서울특별시 성북구 길음로9길 50(길음동),2252,1319,487,798,8,10,0,0,0,4,0,2,1,4,1314,5,933
528,Seongbuk,투표소,KE2,길음제2동제1투,"길음2동주민센터(2층, 대강당)",서울특별시 성북구 삼양로2길 70(길음동),1048,314,120,181,2,3,0,1,1,1,1,1,0,1,312,2,734
529,Seongbuk,투표소,KE2,길음제2동제2투,"래미안길음센터피스아파트(117동 지하1층, 연회장)",서울특별시 성북구 숭인로 50(길음동),3868,2193,772,1344,6,21,0,10,1,12,2,2,1,11,2182,11,1675
530,Seongbuk,투표소,KE2,길음제2동제3투,"성북구길빛도서관(1층, 로비)",서울특별시 성북구 숭인로8길 52(길음동),3358,1665,659,950,5,18,2,2,0,15,3,1,0,3,1658,7,1693
531,Seongbuk,투표소,KE2,길음제2동제4투,"성북구평생학습관(3층, 중강의실)",서울특별시 성북구 종암로 167(하월곡동),2630,1175,409,720,7,16,1,4,0,5,2,0,0,3,1167,8,1455
532,Seongbuk,투표소,JA,종암동제1투,성북구 마을사회적경제센터(2층),서울특별시 성북구 종암로25길 29(종암동),3513,1726,687,969,6,12,2,0,0,19,11,1,0,7,1714,12,1787
533,Seongbuk,투표소,JA,종암동제2투,"삼성래미안세레니티(1층, 대연회장)",서울특별시 성북구 종암로23길 35(종암동),3601,1799,677,1038,10,20,1,7,0,13,2,0,0,7,1775,24,1802
534,Seongbuk,투표소,JA,종암동제3투,"성북노인종합복지관(1층, 로비)",서울특별시 성북구 종암로15길 10(종암동),3355,1630,597,960,9,19,2,2,0,11,6,0,0,8,1614,16,1725
535,Seongbuk,투표소,JA,종암동제4투,"숭례초등학교(1층, 건강교육실)",서울특별시 성북구 종암로5길 14(종암동),3643,1871,642,1089,19,22,5,8,0,31,13,1,0,16,1846,25,1772
536,Seongbuk,투표소,JA,종암동제5투,"종암동주민센터(3층, 대강당)",서울특별시 성북구 종암로 98-8(종암동),2457,974,343,594,2,13,2,2,0,6,1,2,1,4,970,4,1483
537,Seongbuk,투표소,JA,종암동제6투,"SK아파트 관리사무소(1층, 로비)",서울특별시 성북구 종암로24가길 53(종암동),3128,1759,734,957,8,22,3,1,0,17,1,0,0,4,1747,12,1369
538,Seongbuk,투표소,JA,종암동제7투,"서울사대부중(1층, 진로활동실)",서울특별시 성북구 월곡로 36(종암동),3447,1393,581,743,10,24,2,3,0,11,5,0,0,4,1383,10,2054
539,Seongbuk,투표소,JA,종암동제8투,래미안라센트아파트 경로당(1층),서울특별시 성북구 종암로24가길 80(종암동),2836,1420,608,754,5,17,1,1,0,14,3,1,0,5,1409,11,1416
540,Seongbuk,투표소,WK1,월곡제1동제1투,"월곡1동주민센터(4층, 대강당)",서울특별시 성북구 오패산로 96(하월곡동),2820,1302,503,743,7,13,0,5,0,8,3,0,0,3,1285,17,1518
541,Seongbuk,투표소,WK1,월곡제1동제2투,"숭곡초등학교 체육관(1층, 미술실)",서울특별시 성북구 종암로40길 30(하월곡동),2219,893,440,419,4,6,0,2,2,5,1,2,1,5,887,6,1326
542,Seongbuk,투표소,WK1,월곡제1동제3투,월곡1동경로당(1층),서울특별시 성북구 오패산로3길 99(하월곡동),3167,1405,602,714,10,30,1,5,1,17,5,0,0,6,1391,14,1762
543,Seongbuk,투표소,WK1,월곡제1동제4투,"생명의전화 종합사회복지관(1층, 강당)",서울특별시 성북구 오패산로 21(하월곡동),2621,1430,646,729,3,18,2,3,0,11,3,0,1,5,1421,9,1191
544,Seongbuk,투표소,WK1,월곡제1동제5투,"성북구 육아종합지원센터(3층, 아리알찬홀)",서울특별시 성북구 오패산로10길 19(하월곡동),2972,1436,631,725,13,22,1,6,0,12,5,1,0,10,1426,10,1536
545,Seongbuk,투표소,WK1,월곡제1동제6투,"숭인초등학교(1층, 1-1반)",서울특별시 성북구 오패산로16길 37(하월곡동),3448,1678,711,900,8,16,2,3,0,15,7,0,1,5,1668,10,1770
546,Seongbuk,투표소,WK2,월곡제2동제1투,"월곡2동주민센터(2층, 대강당)",서울특별시 성북구 화랑로 152(상월곡동),3428,1298,499,716,15,13,5,1,1,20,4,1,1,7,1283,15,2130
547,Seongbuk,투표소,WK2,월곡제2동제2투,"월곡중학교(1층, 미래창조관)",서울특별시 성북구 장월로 6(상월곡동),3118,1473,581,843,5,16,3,1,0,4,2,1,0,8,1464,9,1645
548,Seongbuk,투표소,WK2,월곡제2동제3투,월곡꿈그림도서관(1층),서울특별시 성북구 화랑로13길 17(하월곡동),3605,1628,631,867,18,20,4,6,0,42,7,0,1,9,1605,23,1977
549,Seongbuk,투표소,WK2,월곡제2동제4투,월곡래미안루나밸리아파트 경로당(1층),서울특별시 성북구 월곡로14길 26(하월곡동),3730,1955,773,1085,14,18,0,9,0,22,6,0,1,9,1937,18,1775
550,Seongbuk,투표소,JWJ1,장위제1동제1투,"장위1동주민센터(2층, 회의실)",서울특별시 성북구 장위로 61(장위동),3086,1255,475,711,12,16,1,0,0,12,4,0,0,11,1242,13,1831
551,Seongbuk,투표소,JW1,장위제1동제2투,"장곡초등학교(1층, 보건교육실)",서울특별시 성북구 장월로23길 16(장위동),3393,1407,547,812,4,16,2,3,0,9,3,0,1,2,1399,8,1986
552,Seongbuk,투표소,JW1,장위제1동제3투,"장위행복누림복합센터(1층, 로비)",서울특별시 성북구 장위로21다길 53(장위동),2880,1024,380,601,6,13,1,1,0,10,0,2,1,1,1016,8,1856
553,Seongbuk,투표소,JW1,장위제1동제4투,"장위1동주민센터(지하1층, 성북여성교실)",서울특별시 성북구 장위로 61(장위동),2032,775,283,458,4,17,3,1,0,3,1,0,0,1,771,4,1257
554,Seongbuk,투표소,JW1,장위제1동제5투,"장위중학교(1층, 진로진학정보실)",서울특별시 성북구 장위로4길 70(장위동),2423,875,373,466,3,8,0,1,1,4,7,1,0,3,867,8,1548
555,Seongbuk,투표소,JW1,장위제1동제6투,"꿈의숲아이파크 716동(2층, 근린공공시설)",서울특별시 성북구 돌곶이로40길 46(장위동),2517,1445,575,816,4,18,0,1,1,10,1,0,1,7,1434,11,1072
556,Seongbuk,투표소,JW2,장위제2동제1투,"장위2동주민센터(1층, 민원실)",서울특별시 성북구 돌곶이로27길 12(장위동),2576,997,337,608,10,4,2,7,0,7,5,1,0,6,987,10,1579
557,Seongbuk,투표소,JW2,장위제2동제2투,우리은행합숙소(1층),서울특별시 성북구 돌곶이로34길 12(장위동),2312,1140,399,703,3,10,1,1,0,3,4,0,0,0,1124,16,1172
558,Seongbuk,투표소,JW2,장위제2동제3투,"장위초등학교(1층, 체육관)",서울특별시 성북구 장월로8가길 41(장위동),2149,901,281,591,4,5,0,0,0,8,3,0,0,1,893,8,1248
559,Seongbuk,투표소,JW2,장위제2동제4투,"장위초등학교(1층, 체육관)",서울특별시 성북구 장월로8가길 41(장위동),3034,1201,428,714,7,23,3,2,0,6,4,0,1,5,1193,8,1833
560,Seongbuk,투표소,JW3,장위제3동제1투,"(구)장위실버복지센터(1층, 로비)",서울특별시 성북구 한천로 655(장위동),1231,357,122,208,4,7,1,1,0,8,2,0,0,1,354,3,874
561,Seongbuk,투표소,JW3,장위제3동제2투,"시립성북청소년수련관(1층, 강당)",서울특별시 성북구 한천로 660-9(장위동),2488,1115,346,728,3,9,1,4,1,8,4,0,0,1,1105,10,1373
562,Seongbuk,투표소,JW3,장위제3동제3투,"래미안퍼스트하이아파트(지하1층, 대회의실)",서울특별시 성북구 한천로 713(장위동),3497,1995,681,1253,9,16,2,4,0,7,4,0,4,8,1988,7,1502
563,Seongbuk,투표소,JW3,장위제3동제4투,"장월초등학교(1층, 중앙로비)",서울특별시 성북구 한천로101길 66(장위동),3659,1905,696,1146,12,13,2,4,0,8,5,0,0,6,1892,13,1754
564,Seongbuk,투표소,SK,석관동제1투,"석관동주민센터(2층, 회의실)",서울특별시 성북구 화랑로 296(석관동),3628,1294,506,726,5,27,0,4,0,11,1,0,1,2,1283,11,2334
565,Seongbuk,투표소,SK,석관동제2투,"석관초등학교(1층, 과학실험실)",서울특별시 성북구 돌곶이로22길 21(석관동),3027,1273,514,712,3,9,0,1,0,18,3,0,0,6,1266,7,1754
566,Seongbuk,투표소,SK,석관동제3투,"석관고등학교(1층, 기술가정실)",서울특별시 성북구 한천로70길 30(석관동),3735,1478,577,819,13,27,2,7,0,13,4,0,1,6,1469,9,2257
567,Seongbuk,투표소,SK,석관동제4투,"석관중학교(2층, 체육관)",서울특별시 성북구 한천로 526(석관동),3182,1470,529,873,7,19,3,3,1,12,5,0,0,2,1454,16,1712
568,Seongbuk,투표소,SK,석관동제5투,"성북종합레포츠타운(1층, 어린이체육관)",서울특별시 성북구 한천로58길 307(석관동),3671,1973,687,1228,5,15,0,3,1,15,4,0,0,7,1965,8,1698
569,Seongbuk,투표소,SK,석관동제6투,석관실버복지센터(1층),서울특별시 성북구 화랑로32길 88(석관동),2690,1161,495,594,8,17,1,1,1,18,2,1,2,7,1147,14,1529
570,Seongbuk,투표소,SK,석관동제7투,"강북신협(지하1층, 강당)",서울특별시 성북구 돌곶이로 59(석관동),3243,1435,515,843,15,17,3,3,0,12,4,2,0,16,1430,5,1808
571,Seongbuk,투표소,SK,석관동제8투,"신동아파밀리에아파트(1층, 커뮤니티센터)",서울특별시 성북구 화랑로 210-26(석관동),1987,840,329,460,4,10,5,2,0,11,3,0,0,10,834,6,1147
572,Gangbuk,투표소,SY,삼양동제1투,"삼양동주민센터(3층, 대회의실)",서울특별시 강북구 삼양로 268(미아동),1153,352,146,199,3,1,0,0,0,1,0,0,0,0,350,2,801
573,Gangbuk,투표소,SY,삼양동제2투,"강북노인회관(4층, 강당)",서울특별시 강북구 삼양로 280-1(미아동),2252,850,352,462,1,11,2,1,1,7,3,0,0,3,843,7,1402
574,Gangbuk,투표소,SY,삼양동제3투,"삼양초등학교(3층, 장미반)",서울특별시 강북구 삼양로49길 17(미아동),2353,814,377,402,2,9,4,1,0,3,2,1,0,2,803,11,1539
575,Gangbuk,투표소,SY,삼양동제4투,"구세군강북종합사회복지관(지하1층, 경로식당)",서울특별시 강북구 인수봉로20가길 24(미아동),2959,1127,522,552,7,20,0,3,0,12,3,2,0,2,1123,4,1832
576,Gangbuk,투표소,SY,삼양동제5투,"삼양동자치회관 솔샘관(1층, 강당)",서울특별시 강북구 솔샘로 177(미아동),3032,1442,663,727,7,11,5,4,0,4,4,2,0,2,1429,13,1590
577,Gangbuk,투표소,SY,삼양동제6투,"삼양초등학교(3층, 실과실)",서울특별시 강북구 삼양로49길 17(미아동),1851,669,322,307,8,11,0,4,0,3,1,2,2,3,663,6,1182
578,Gangbuk,투표소,SY,삼양동제7투,"삼양동종합복지센터(지하1층, 경로식당)",서울특별시 강북구 삼양로47길 9(미아동),1386,592,246,328,1,4,0,1,0,3,1,1,0,0,585,7,794
579,Gangbuk,투표소,SY,삼양동제8투,"벽산라이브파크아파트 제2관리사무소(1층, 할아버지방)","서울특별시 강북구 솔샘로 159(미아동, 벽산라이브파크아파트)",2357,1306,575,674,6,19,0,3,0,4,6,1,1,3,1292,14,1051
580,Gangbuk,투표소,MA,미아동제1투,"미아동주민센터(2층, 대강당)",서울특별시 강북구 솔매로49길 14(미아동),3070,1241,540,621,10,24,1,2,0,15,3,0,1,2,1219,22,1829
581,Gangbuk,투표소,MA,미아동제2투,율곡경로당(1층),서울특별시 강북구 오패산로52아길 11(미아동),1502,733,337,371,1,5,3,0,0,3,6,0,0,0,726,7,769
582,Gangbuk,투표소,MA,미아동제3투,"한국전력공사 강북성북지사(1층, 로비)",서울특별시 강북구 도봉로 242(미아동),3918,1657,649,899,13,19,2,0,1,35,4,0,0,9,1631,26,2261
583,Gangbuk,투표소,MA,미아동제4투,"미아동공영주차장(지하1층, 헬스장)",서울특별시 강북구 도봉로61길 46(미아동),2782,1166,487,604,5,19,3,7,1,19,6,0,0,2,1153,13,1616
584,Gangbuk,투표소,MA,미아동제5투,한빛경로당(1층),서울특별시 강북구 솔매로43길 25(미아동),2490,1066,418,572,4,23,4,2,0,11,2,2,0,11,1049,17,1424
585,Gangbuk,투표소,MA,미아동제6투,"미아동주민센터(2층, 문화강좌실)",서울특별시 강북구 솔매로49길 14(미아동),2676,968,413,502,6,12,2,1,0,10,5,1,1,2,955,13,1708
586,Gangbuk,투표소,SJ,송중동제1투,"송중동주민센터(지하1층, 회의실)",서울특별시 강북구 오패산로 162(미아동),2468,907,373,483,3,18,0,3,0,10,2,2,1,3,898,9,1561
587,Gangbuk,투표소,SJ,송중동제2투,"송중초등학교(1층, 음악실)",서울특별시 강북구 오현로 9(미아동),2461,902,358,501,5,10,2,2,0,12,3,0,1,3,897,5,1559
588,Gangbuk,투표소,SJ,송중동제3투,경남아너스빌 경로당(1층),"서울특별시 강북구 오패산로30길 30(미아동, 경남아너스빌아파트)",2995,1492,570,870,6,28,2,1,0,4,1,1,2,3,1488,4,1503
589,Gangbuk,투표소,SJ,송중동제4투,"구립 원송경로당(1층, 할아버지방)",서울특별시 강북구 오패산로 156-3(미아동),2660,1001,427,535,8,10,1,2,0,7,2,2,0,2,996,5,1659
590,Gangbuk,투표소,SJ,송중동제5투,"꿈의숲해링턴플레이스(1층, 104동 경로당)","서울특별시 강북구 오현로 45(미아동, 꿈의숲 해링턴 플레이스)",2563,1350,522,766,9,17,1,9,0,7,4,0,0,5,1340,10,1213
591,Gangbuk,투표소,SJ,송중동제6투,"송중초등학교(2층, 체육관)",서울특별시 강북구 오현로 9(미아동),2323,968,428,506,6,12,0,3,1,3,2,1,1,2,965,3,1355
592,Gangbuk,투표소,SJ,송중동제7투,"화계초등학교 신관(1층, GX룸)",서울특별시 강북구 솔매로50가길 25(미아동),3004,1323,589,682,3,16,2,4,0,10,2,1,0,4,1313,10,1681
593,Gangbuk,투표소,SJ,송중동제8투,"화계초등학교 서관(1층, 교직원식당)",서울특별시 강북구 솔매로50가길 25(미아동),2519,923,423,467,5,10,0,0,0,6,2,0,0,4,917,6,1596
594,Gangbuk,투표소,SCH,송천동제1투,"송천동주민센터(2층, 회의실)",서울특별시 강북구 솔샘로 284(미아동),2574,976,386,542,9,14,3,1,0,5,4,0,0,3,967,9,1598
595,Gangbuk,투표소,SCH,송천동제2투,"송천초등학교 본관(1층, 과학2실)",서울특별시 강북구 삼양로20길 29(미아동),2139,900,378,481,9,12,0,0,1,5,1,0,1,6,894,6,1239
596,Gangbuk,투표소,SCH,송천동제3투,"영훈초등학교 후문 담장옆 신축건물(1층, 상가)",서울특별시 강북구 숭인로 53(미아동),2450,1165,471,641,5,18,2,4,0,6,6,1,0,2,1156,9,1285
597,Gangbuk,투표소,SCH,송천동제4투,"미아동부센트레빌 관리사무소(1층, 회의실)","서울특별시 강북구 숭인로7가길 37(미아동, 미아동부센트레빌아파트)",2355,1207,466,689,9,15,1,1,0,9,1,0,0,5,1196,11,1148
598,Gangbuk,투표소,SCH,송천동제5투,"강북청소년문화정보도서관(1층, 강의실)",서울특별시 강북구 삼양로54길 68(미아동),2772,1255,571,633,3,21,1,3,0,4,3,1,0,5,1245,10,1517
599,Gangbuk,투표소,SCH,송천동제6투,"송천동자치회관(1층, 강당)",서울특별시 강북구 도봉로27길 90(미아동),2392,912,411,459,4,8,1,3,0,4,5,1,1,5,902,10,1480
600,Gangbuk,투표소,SCH,송천동제7투,"강북청소년문화정보도서관(지하1층, 시청각실)",서울특별시 강북구 삼양로54길 68(미아동),2770,1081,473,555,7,13,0,4,1,6,3,0,0,1,1063,18,1689
601,Gangbuk,투표소,SCH,송천동제8투,"송천동자치회관(1층, 강당)",서울특별시 강북구 도봉로27길 90(미아동),2572,1064,478,544,5,14,0,3,0,7,1,0,0,6,1058,6,1508
602,Gangbuk,투표소,SKS,삼각산동제1투,"삼각산동주민센터(지하1층, 다목적강당)",서울특별시 강북구 삼양로19길 34(미아동),2390,1096,480,561,8,19,0,3,0,10,5,0,0,4,1090,6,1294
603,Gangbuk,투표소,SKS,삼각산동제2투,"강북구보건소 삼각산분소(3층, 주프로그램실)",서울특별시 강북구 삼양로19길 154(미아동),2098,845,363,456,4,8,0,4,0,2,2,0,1,1,841,4,1253
604,Gangbuk,투표소,SKS,삼각산동제3투,"삼각산초등학교(1층, 시청각실)",서울특별시 강북구 삼양로19길 141(미아동),2927,1423,678,697,10,14,2,4,0,5,0,0,0,3,1413,10,1504
605,Gangbuk,투표소,SKS,삼각산동제4투,"SK북한산시티아파트 관리사무소(1층, 문화강좌실)","서울특별시 강북구 솔샘로 174(미아동, SK북한산시티아파트)",2196,1267,486,717,6,19,5,0,0,11,6,0,1,9,1260,7,929
606,Gangbuk,투표소,SKS,삼각산동제5투,"SK북한산시티아파트 관리사무소(2층, 구대표자회의실)","서울특별시 강북구 솔샘로 174(미아동, SK북한산시티아파트)",2938,1712,770,869,12,22,3,4,1,9,7,0,0,5,1702,10,1226
607,Gangbuk,투표소,SKS,삼각산동제6투,삼성래미안트리베라2차아파트 주민공동시설(1층),"서울특별시 강북구 삼양로27길 19(미아동, 삼성래미안트리베라2차아파트)",2343,1172,446,688,7,11,4,0,0,7,4,0,1,3,1171,1,1171
608,Gangbuk,투표소,SKS,삼각산동제7투,삼성래미안트리베라1차아파트 주민공동시설(1층),"서울특별시 강북구 삼양로19길 25(미아동, 삼성래미안트리베라1차아파트)",2126,1105,427,639,8,11,1,1,0,4,3,0,0,5,1099,6,1021
609,Gangbuk,투표소,SKS,삼각산동제8투,"두산위브트레지움아파트 커뮤니티센터(1층, 북카페)","서울특별시 강북구 삼양로27길 95(미아동, 두산위브 아파트 1단지)",2416,1280,585,657,8,9,2,0,0,9,1,0,0,1,1272,8,1136
610,Gangbuk,투표소,WI,우이동제1투,"강북구새마을회관(3층, 강당)",서울특별시 강북구 4.19로 8-1(수유동),2304,875,302,516,8,8,0,3,0,17,2,0,0,8,864,11,1429
611,Gangbuk,투표소,WI,우이동제2투,"강북구새마을회관(1층, 나눔터)",서울특별시 강북구 4.19로 8-1(수유동),2901,1058,421,579,7,23,1,3,0,6,0,0,0,6,1046,12,1843
612,Gangbuk,투표소,WI,우이동제3투,"시립강북청소년센터(1층, 체육관)",서울특별시 강북구 4.19로 74(수유동),2815,1117,431,626,6,17,2,3,0,10,2,2,0,9,1108,9,1698
613,Gangbuk,투표소,WI,우이동제4투,"서라벌중학교(1층, 실내체육실)",서울특별시 강북구 삼양로155길 37-9(우이동),3452,1586,644,868,4,21,2,2,0,14,3,2,1,10,1571,15,1866
614,Gangbuk,투표소,WI,우이동제5투,"블랙야크 알파인클럽센터(4층, 강의실)",서울특별시 강북구 삼양로173길 52(우이동),3054,1479,542,877,2,21,3,3,0,7,1,0,1,6,1463,16,1575
615,Gangbuk,투표소,IS,인수동제1투,"강북문화예술회관(1층, 대공연장 로비)",서울특별시 강북구 삼각산로 85(수유동),2266,851,308,512,4,9,1,0,0,6,3,0,0,2,845,6,1415
616,Gangbuk,투표소,IS,인수동제2투,"인수초등학교 본관(1층, 학부모회의실)",서울특별시 강북구 인수봉로 269(수유동),2017,803,286,484,5,10,0,1,0,3,1,0,0,3,793,10,1214
617,Gangbuk,투표소,IS,인수동제3투,"인수중학교(1층, 보건교육실)",서울특별시 강북구 인수봉로75길 10(수유동),2620,989,426,526,5,16,1,1,0,6,2,0,1,1,985,4,1631
618,Gangbuk,투표소,IS,인수동제4투,"인수초등학교 후관(1층, 다목적실)",서울특별시 강북구 인수봉로 269(수유동),2207,1016,382,591,10,10,2,2,0,3,1,0,0,3,1004,12,1191
619,Gangbuk,투표소,IS,인수동제5투,"우이초등학교(1층, 나래관)",서울특별시 강북구 삼양로99길 36(수유동),2643,853,380,434,4,12,2,1,0,9,1,0,0,1,844,9,1790
620,Gangbuk,투표소,IS,인수동제6투,"우이초등학교(1층, 나래관)",서울특별시 강북구 삼양로99길 36(수유동),2819,1058,437,573,4,16,2,2,0,7,2,1,0,2,1046,12,1761
621,Gangbuk,투표소,IS,인수동제7투,"우이초등학교(1층, 나래관)",서울특별시 강북구 삼양로99길 36(수유동),3478,1289,544,663,13,17,0,2,1,12,10,0,1,15,1278,11,2189
622,Gangbuk,투표소,IS,인수동제8투,"우이초등학교(1층, 나래관)",서울특별시 강북구 삼양로99길 36(수유동),3191,1262,535,669,10,10,2,2,1,5,2,0,2,8,1246,16,1929
623,Gangbuk,투표소,B1,번1동제1투,"번1동주민센터(4층, 강좌실1)",서울특별시 강북구 덕릉로41길 74(번동),3069,1011,399,536,9,23,2,2,0,14,3,0,0,4,992,19,2058
624,Gangbuk,투표소,B1,번1동제2투,"번1동주민센터(3층, 회의실)",서울특별시 강북구 덕릉로41길 74(번동),2532,987,420,521,7,8,1,2,0,10,3,0,0,3,975,12,1545
625,Gangbuk,투표소,B1,번1동제3투,"수송초등학교(1층, 다목적실)",서울특별시 강북구 한천로124길 14(번동),3243,1139,383,679,8,29,1,1,0,14,4,3,0,2,1124,15,2104
626,Gangbuk,투표소,B1,번1동제4투,"수송초등학교(1층, 다목적실)",서울특별시 강북구 한천로124길 14(번동),2838,1094,452,603,6,11,1,4,0,5,1,0,1,4,1088,6,1744
627,Gangbuk,투표소,B1,번1동제5투,"수송중학교 솔빛관(1층, 로비)",서울특별시 강북구 한천로122길 21(번동),2116,902,364,499,6,12,3,4,0,6,1,2,0,1,898,4,1214
628,Gangbuk,투표소,B2,번2동제1투,"번2동주민센터(2층, 회의실)",서울특별시 강북구 한천로 897(번동),2558,1219,449,730,9,16,1,2,0,3,0,0,1,2,1213,6,1339
629,Gangbuk,투표소,B2,번2동제2투,"번동5단지종합사회복지관(1층, 경로식당)","서울특별시 강북구 한천로115길 20(번동, 번동주공5단지아파트)",1836,822,359,420,9,11,0,0,0,1,2,0,0,4,806,16,1014
630,Gangbuk,투표소,B2,번2동제3투,"서울북부고용노동지청(4층, 대회의실)",서울특별시 강북구 한천로 949(번동),2748,1149,483,611,7,17,2,0,1,9,5,1,1,3,1140,9,1599
631,Gangbuk,투표소,B2,번2동제4투,"강북문화정보도서관(1층, 로비)",서울특별시 강북구 오현로 145(번동),2253,905,399,462,2,18,0,3,0,4,3,1,0,3,895,10,1348
632,Gangbuk,투표소,B2,번2동제5투,"번동햇살공영주차장 (지상3층, 번동 U-도서관)",서울특별시 강북구 오현로21길 84(번동),2154,932,404,474,9,6,2,2,1,13,4,1,0,1,917,15,1222
633,Gangbuk,투표소,B3,번3동제1투,"오현초등학교(1층, 꿈나무교실)",서울특별시 강북구 월계로 221(번동),1786,675,253,401,1,7,0,1,1,3,2,1,0,0,670,5,1111
634,Gangbuk,투표소,B3,번3동제2투,"오현초등학교(1층, 다목적실)",서울특별시 강북구 월계로 221(번동),2540,1235,516,661,10,12,2,4,0,12,5,0,0,6,1228,7,1305
635,Gangbuk,투표소,B3,번3동제3투,"번3동주민센터(3층, 강당)",서울특별시 강북구 한천로105길 21(번동),1849,751,331,390,2,11,0,3,0,4,2,0,0,1,744,7,1098
636,Gangbuk,투표소,B3,번3동제4투,"번동초등학교(1층, 한울관)",서울특별시 강북구 오현로 204(번동),2609,1310,526,721,5,23,3,3,0,6,4,1,2,4,1298,12,1299
637,Gangbuk,투표소,B3,번3동제5투,"번동초등학교 신관(1층, 로비)",서울특별시 강북구 오현로 204(번동),2771,1330,524,745,6,18,2,2,0,11,3,1,0,2,1314,16,1441
638,Gangbuk,투표소,SY1,수유1동제1투,"수유1동주민센터(지하1층, 주차장)",서울특별시 강북구 삼양로 299(수유동),2801,1004,393,554,4,12,4,5,1,9,1,0,0,10,993,11,1797
639,Gangbuk,투표소,SY1,수유1동제2투,한빛맹학교 지하주차장(지하1층),서울특별시 강북구 삼양로73가길 47(수유동),2654,1074,475,551,9,12,1,4,2,5,1,1,1,5,1067,7,1580
640,Gangbuk,투표소,SY1,수유1동제3투,"혜화여자고등학교(1층, 체육관)",서울특별시 강북구 인수봉로 127(수유동),2793,979,421,508,4,17,1,7,0,5,3,1,0,5,972,7,1814
641,Gangbuk,투표소,SY1,수유1동제4투,"수유1동주민센터(5층, 다목적강당)",서울특별시 강북구 삼양로 299(수유동),2920,1083,467,557,4,22,0,4,1,11,5,0,1,3,1075,8,1837
642,Gangbuk,투표소,SY1,수유1동제5투,"수유초등학교(1층, 창의실)",서울특별시 강북구 삼양로74길 39(수유동),3962,1410,567,765,10,24,0,2,2,13,9,1,1,7,1401,9,2552
643,Gangbuk,투표소,SY2,수유2동제1투,"수유2동주민센터(3층, 303호강의실)",서울특별시 강북구 한천로 1117(수유동),2822,1308,460,798,7,16,0,0,0,15,0,1,0,2,1299,9,1514
644,Gangbuk,투표소,SY2,수유2동제2투,"대한적십자사 강북봉사나눔터(1층, 조리실)",서울특별시 강북구 한천로170길 23(수유동),3652,1395,541,768,11,19,3,7,0,22,2,1,2,5,1381,14,2257
645,Gangbuk,투표소,SY2,수유2동제3투,"수유벽산아파트관리사무소(1층, 회의실)","서울특별시 강북구 삼각산로 143-1(수유동, 수유벽산아파트)",2599,1422,450,929,4,9,1,0,0,11,4,0,2,4,1414,8,1177
646,Gangbuk,투표소,SY2,수유2동제4투,"수유2동주민센터(4층, 대강당)",서울특별시 강북구 한천로 1117(수유동),2394,915,380,492,5,9,3,3,0,4,2,2,1,4,905,10,1479
647,Gangbuk,투표소,SY2,수유2동제5투,"수유2동주민센터(2층, 기획상황실)",서울특별시 강북구 한천로 1117(수유동),3131,1219,495,670,5,18,1,5,0,5,6,1,0,3,1209,10,1912
648,Gangbuk,투표소,SY3,수유3동제1투,"강북구청(4층, 대강당)",서울특별시 강북구 도봉로89길 13(수유동),1960,729,266,405,5,15,1,2,0,8,5,0,1,2,710,19,1231
649,Gangbuk,투표소,SY3,수유3동제2투,"강북중학교 신관(1층, 지혜의 샘터)",서울특별시 강북구 한천로150길 67(수유동),3298,1342,555,713,7,23,0,1,0,13,4,0,1,4,1321,21,1956
650,Gangbuk,투표소,SY3,수유3동제3투,"강북중학교 신관(1층, 지혜의 샘터)",서울특별시 강북구 한천로150길 67(수유동),2966,991,379,555,6,23,0,2,0,5,0,0,0,9,979,12,1975
651,Gangbuk,투표소,SY3,수유3동제4투,"수유중앙시장(1층, 수유중앙시장 내)",서울특별시 강북구 노해로17길 26(수유동),2970,1338,569,716,8,10,2,2,0,12,2,1,1,4,1327,11,1632
652,Gangbuk,투표소,SY3,수유3동제5투,"수유3동주민센터(2층, 강좌실)",서울특별시 강북구 노해로 36(수유동),3569,1302,567,654,7,22,3,3,0,20,4,2,0,9,1291,11,2267
653,Gangbuk,투표소,SY3,수유3동제6투,"광산빌라트(1층, 주차장)","서울특별시 강북구 수유로17길 48(수유동, 광산빌라트)",3204,1404,591,732,8,29,0,3,0,7,1,0,0,8,1379,25,1800
654,Dobong,투표소,SSM1,쌍문1동제1투,"쌍문동어르신복지관(3층, 강당)",서울특별시 도봉구 우이천로 363(쌍문동),3223,1220,482,678,11,19,0,3,0,10,1,1,1,3,1209,11,2003
655,Dobong,투표소,SSM1,쌍문1동제2투,"쌍문초등학교(1층, 시청각실 로비)",서울특별시 도봉구 우이천로 360(쌍문동),3056,1221,517,643,10,18,1,0,0,13,3,0,0,7,1212,9,1835
656,Dobong,투표소,SSM1,쌍문1동제3투,계성경로당,서울특별시 도봉구 우이천로30길 25(쌍문동),2466,1135,449,638,4,14,3,2,0,10,3,0,1,2,1126,9,1331
657,Dobong,투표소,SSM1,쌍문1동제4투,"백운초등학교(동관 1층, 1-2반)",서울특별시 도봉구 삼양로146길 17(쌍문동),3615,1622,655,865,18,21,1,2,0,35,3,1,2,5,1608,14,1993
658,Dobong,투표소,SSM1,쌍문1동제5투,"효문중학교(본관 1층, 로비)",서울특별시 도봉구 우이천로 432(쌍문동),2878,1287,510,697,13,20,3,2,0,11,4,0,1,7,1268,19,1591
659,Dobong,투표소,SSM2,쌍문2동제1투,"백운중학교(1층, 백운글방)",서울특별시 도봉구 도봉로129길 50(쌍문동),3269,1205,474,665,17,18,1,2,0,9,1,0,0,4,1191,14,2064
660,Dobong,투표소,SSM2,쌍문2동제2투,금강아미움파크타운아파트상가 112호(1층),"서울특별시 도봉구 방학로5길 33(쌍문동, 금강아미움파크타운)",2939,1187,458,667,7,22,1,2,2,12,2,0,0,4,1177,10,1752
661,Dobong,투표소,SSM2,쌍문2동제3투,"도봉노인종합복지관(1층, 담소실)",서울특별시 도봉구 도당로2길 12-13(쌍문동),2198,1003,344,618,11,13,0,2,0,5,4,1,1,0,999,4,1195
662,Dobong,투표소,SSM2,쌍문2동제4투,삼익아파트경로당(1층),서울특별시 도봉구 해등로 195(쌍문동),2596,1421,520,854,9,13,1,1,1,9,2,1,0,2,1413,8,1175
663,Dobong,투표소,SSM2,쌍문2동제5투,백운경로당(1층),서울특별시 도봉구 노해로57길 62(쌍문동),2532,1092,462,570,6,20,2,2,0,11,3,0,0,7,1083,9,1440
664,Dobong,투표소,SSM3,쌍문3동제1투,"쌍문3동주민센터(3층, 강당)",서울특별시 도봉구 노해로44길 9(쌍문동),3444,1381,571,749,5,20,3,4,0,9,3,3,0,4,1371,10,2063
665,Dobong,투표소,SSM3,쌍문3동제2투,"신도봉중학교(서관 1층, 가사실)",서울특별시 도봉구 도봉로115길 16(쌍문동),3116,1253,516,669,8,23,2,2,0,11,3,0,0,8,1242,11,1863
666,Dobong,투표소,SSM3,쌍문3동제3투,"신도봉중학교(정보관 1층, 도서실)",서울특별시 도봉구 도봉로115길 16(쌍문동),2750,1153,474,623,10,17,0,0,0,10,4,1,0,3,1142,11,1597
667,Dobong,투표소,SSM3,쌍문3동제4투,"신도봉중학교(정보관 1층, 멀티미디어실)",서울특별시 도봉구 도봉로115길 16(쌍문동),2750,1204,441,704,7,18,1,1,0,13,7,0,1,3,1196,8,1546
668,Dobong,투표소,SSM4,쌍문4동제1투,"쌍문4동주민센터(지하1층, 대강당)",서울특별시 도봉구 시루봉로 62-7(쌍문동),2726,1233,497,681,7,21,2,0,0,9,3,0,0,4,1224,9,1493
669,Dobong,투표소,SSM4,쌍문4동제2투,도봉환경교육센터(1층),서울특별시 도봉구 시루봉로6길 33(방학동),3027,1545,535,948,11,21,1,2,0,11,3,0,2,2,1536,9,1482
670,Dobong,투표소,SSM4,쌍문4동제3투,"한양 2차,3차,4차 아파트 경로당(1층)","서울특별시 도봉구 해등로 231(쌍문동, 한양2차아파트)",2763,1420,511,863,1,14,0,2,0,8,1,0,2,4,1406,14,1343
671,Dobong,투표소,SSM4,쌍문4동제4투,한양6차아파트 경로당(1층),서울특별시 도봉구 시루봉로 58(쌍문동),3354,1542,609,872,12,19,2,5,0,6,3,0,1,8,1537,5,1812
672,Dobong,투표소,BH1,방학1동제1투,"방학1동주민센터(지하1층, 대강당)",서울특별시 도봉구 방학로2길 27(방학동),2685,961,382,536,4,12,1,1,1,9,2,1,0,2,951,10,1724
673,Dobong,투표소,BH1,방학1동제2투,방학1동주민센터(2층),서울특별시 도봉구 방학로2길 27(방학동),2683,1142,467,623,5,20,1,4,0,5,2,2,1,1,1131,11,1541
674,Dobong,투표소,BH1,방학1동제3투,도봉새마을금고 본점(1층),서울특별시 도봉구 도당로 134(방학동),3149,1309,551,711,6,15,1,5,0,6,4,0,0,1,1300,9,1840
675,Dobong,투표소,BH1,방학1동제4투,"동부센트레빌아파트 104동(1층, 입주자 대표회의실)",서울특별시 도봉구 방학로 112-9(방학동),3374,1431,543,844,4,9,2,1,1,14,3,0,0,2,1423,8,1943
676,Dobong,투표소,BH1,방학1동제5투,"문화고등학교(신관 1층, 103호)",서울특별시 도봉구 마들로 598(방학동),3054,1209,461,690,7,19,1,2,1,12,1,1,0,5,1200,9,1845
677,Dobong,투표소,BH1,방학1동제6투,"창도초등학교(별관 1층, 방과후5실)",서울특별시 도봉구 방학로 32-28(방학동),2323,1055,287,746,2,5,0,3,1,2,0,0,2,2,1050,5,1268
678,Dobong,투표소,BH1,방학1동제7투,"창동중학교 본관(1층, 스마트 교실)",서울특별시 도봉구 방학로 32(방학동),2323,1285,410,837,7,11,0,2,0,9,1,1,0,0,1278,7,1038
679,Dobong,투표소,BH2,방학2동제1투,"방학2동주민센터(3층, 강당)",서울특별시 도봉구 시루봉로 226(방학동),2470,826,326,470,3,14,1,3,0,4,1,0,0,1,823,3,1644
680,Dobong,투표소,BH2,방학2동제2투,"방아골종합사회복지관(2층, 강당)",서울특별시 도봉구 시루봉로17길 42(방학동),1981,879,356,477,7,6,4,3,0,4,4,1,0,6,868,11,1102
681,Dobong,투표소,BH2,방학2동제3투,"방학중학교(도담관 1층, 체육관)",서울특별시 도봉구 시루봉로 188(방학동),2504,974,377,545,5,19,0,2,0,4,6,0,1,4,963,11,1530
682,Dobong,투표소,BH2,방학2동제4투,"방학초등학교(본관 1층, 회의실)",서울특별시 도봉구 도당로9길 34(방학동),2556,1069,409,619,3,16,0,0,0,12,1,0,2,2,1064,5,1487
683,Dobong,투표소,BH2,방학2동제5투,"방학초등학교(후관 1층, 보건교육실)",서울특별시 도봉구 도당로9길 34(방학동),2379,798,300,466,5,7,0,0,0,5,2,0,0,3,788,10,1581
684,Dobong,투표소,BH2,방학2동제6투,"청학경로당(1층, 할머니방)",서울특별시 도봉구 도당로13라길 104-4(방학동),2323,934,375,520,3,13,2,1,0,7,3,0,0,3,927,7,1389
685,Dobong,투표소,BH3,방학3동제1투,"방학3동주민센터(2층, 은행나루)",서울특별시 도봉구 시루봉로 94(방학동),2560,1085,429,625,1,7,0,4,0,8,3,0,0,1,1078,7,1475
686,Dobong,투표소,BH3,방학3동제2투,"신방학중학교(1층, 가사실)",서울특별시 도봉구 시루봉로 156(방학동),2805,1399,518,826,5,15,1,5,0,17,2,0,0,3,1392,7,1406
687,Dobong,투표소,BH3,방학3동제3투,"방학3동 주민센터(3층, 대강당)",서울특별시 도봉구 시루봉로 94(방학동),3038,1440,526,868,3,12,1,1,0,10,0,1,0,6,1428,12,1598
688,Dobong,투표소,BH3,방학3동제4투,"신학초등학교(1층, 과학실)",서울특별시 도봉구 방학로 247-21(방학동),2308,1060,415,603,6,12,0,7,0,6,2,0,0,6,1057,3,1248
689,Dobong,투표소,BH3,방학3동제5투,"김수영문학관(4층, 강당)",서울특별시 도봉구 해등로32길 80(방학동),2228,1193,464,686,4,7,2,2,0,10,2,0,0,4,1181,12,1035
690,Dobong,투표소,BH3,방학3동제6투,"초당초등학교(2층, 3-2교실)",서울특별시 도봉구 해등로32길 11(방학동),2254,1202,518,637,5,13,1,3,1,4,6,0,0,6,1194,8,1052
691,Dobong,투표소,BH3,방학3동제7투,"초당초등학교(1층, 다목적실)",서울특별시 도봉구 해등로32길 11(방학동),2383,1140,482,613,3,15,0,2,0,8,4,1,0,2,1130,10,1243
692,Dobong,투표소,CH1,창1동제1투,주공3단지아파트 경로당(1층),서울특별시 도봉구 해등로 50(창동),3046,1669,588,1015,11,16,1,3,0,15,5,1,2,5,1662,7,1377
693,Dobong,투표소,CH1,창1동제2투,"창북중학교(1층, 학부모실)",서울특별시 도봉구 노해로62길 33(창동),2434,902,326,539,5,7,2,2,0,6,3,0,0,3,893,9,1532
694,Dobong,투표소,CH1,창1동제3투,"창동고등학교(1층, 소회의실)",서울특별시 도봉구 노해로62길 7(창동),2753,992,408,535,9,15,1,3,0,7,1,1,1,6,987,5,1761
695,Dobong,투표소,CH1,창1동제4투,"창일중학교(1층, 교직원 식당)",서울특별시 도봉구 노해로66길 60(창동),3151,1584,597,923,4,16,2,2,0,11,6,1,0,6,1568,16,1567
696,Dobong,투표소,CH1,창1동제5투,"창일초등학교(1층, 실과실)",서울특별시 도봉구 노해로66길 84(창동),3259,1777,694,1003,6,18,1,3,1,18,5,0,1,15,1765,12,1482
697,Dobong,투표소,CH1,창1동제6투,"창동종합사회복지관(3층, 강당)",서울특별시 도봉구 덕릉로 329(창동),2545,1267,543,687,8,11,3,0,0,4,1,0,0,4,1261,6,1278
698,Dobong,투표소,CH2,창2동제1투,"창동레지던시(1층, 전시장)",서울특별시 도봉구 덕릉로 257(창동),3089,1112,462,585,6,21,3,3,0,11,2,0,1,3,1097,15,1977
699,Dobong,투표소,CH2,창2동제2투,"창2동주민센터(3층, 대강당)",서울특별시 도봉구 덕릉로59길 73-3(창동),3466,1324,503,762,6,20,1,3,0,10,5,1,1,5,1317,7,2142
700,Dobong,투표소,CH2,창2동제3투,"대우아파트 경로당(1층, 할아버지방)","서울특별시 도봉구 덕릉로63가길 43(창동, 창동대우아파트)",3182,1538,673,811,10,16,0,1,0,5,6,0,0,4,1526,12,1644
701,Dobong,투표소,CH2,창2동제4투,태영데시앙아파트 경로당(1층),서울특별시 도봉구 도봉로110다길 51(창동),3628,1755,620,1056,12,33,1,3,0,12,5,0,0,1,1743,12,1873
702,Dobong,투표소,CH2,창2동제5투,장수경로당(1층),서울특별시 도봉구 도봉로104길 101(창동),3426,1379,541,781,8,15,2,3,0,11,3,1,2,5,1372,7,2047
703,Dobong,투표소,CH2,창2동제6투,"창림초등학교(1층, 상담실)",서울특별시 도봉구 덕릉로63길 46(창동),3592,1294,514,716,10,13,1,2,0,8,8,1,2,3,1278,16,2298
704,Dobong,투표소,CH3,창3동제1투,"창3동주민센터(3층, 대강당)",서울특별시 도봉구 덕릉로62길 89(창동),2316,837,345,451,4,19,1,4,0,3,3,1,0,2,833,4,1479
705,Dobong,투표소,CH3,창3동제2투,"창3동주민센터(1층, 문화의집 로비)",서울특별시 도봉구 덕릉로62길 89(창동),2924,1138,466,631,2,11,1,3,0,4,3,1,1,5,1128,10,1786
706,Dobong,투표소,CH3,창3동제3투,"신화초등학교(본관 1층, 과학실)",서울특별시 도봉구 우이천로 120(창동),2088,778,314,433,3,10,2,0,0,5,1,0,1,3,772,6,1310
707,Dobong,투표소,CH3,창3동제4투,"신화초등학교(후관 1층, 도움반2)",서울특별시 도봉구 우이천로 120(창동),2567,1123,463,597,11,20,1,3,0,7,4,3,0,2,1111,12,1444
708,Dobong,투표소,CH4,창4동제1투,"노곡중학교(1층, 영어전용교실)",서울특별시 도봉구 노해로70길 95(창동),2852,1308,498,756,8,11,0,6,0,11,5,0,1,4,1300,8,1544
709,Dobong,투표소,CH4,창4동제2투,"서울외국어고등학교(1층, 현관로비)",서울특별시 도봉구 덕릉로66길 22(창동),2418,1119,457,612,7,12,1,4,0,8,5,0,0,4,1110,9,1299
710,Dobong,투표소,CH4,창4동제3투,"월천초등학교(1층, 채움터)",서울특별시 도봉구 노해로70길 96(창동),2981,1490,512,917,7,11,4,3,1,15,6,0,1,4,1481,9,1491
711,Dobong,투표소,CH4,창4동제4투,동아청솔아파트 경로당(1층),서울특별시 도봉구 노해로69길 103(창동),3283,2011,732,1202,8,18,3,6,0,16,4,0,0,9,1998,13,1272
712,Dobong,투표소,CH4,창4동제5투,"자운초등학교(1층, 보건교육실)",서울특별시 도봉구 마들로13길 166(창동),2756,1504,531,923,6,13,2,3,0,9,2,0,0,4,1493,11,1252
713,Dobong,투표소,CH4,창4동제6투,"현대2,3차아파트 경로당(1층)",서울특별시 도봉구 도봉로136길 111(창동),3407,2020,791,1154,18,18,2,2,0,8,2,0,0,10,2005,15,1387
714,Dobong,투표소,CH5,창5동제1투,"도봉구민회관(1층, 전시실)",서울특별시 도봉구 도봉로 552(창동),2830,1340,554,729,12,17,2,5,0,9,3,1,1,1,1334,6,1490
715,Dobong,투표소,CH5,창5동제2투,창원초등학교 체육관동(2층),서울특별시 도봉구 해등로 103(창동),2150,948,375,541,1,13,0,3,0,6,0,0,1,2,942,6,1202
716,Dobong,투표소,CH5,창5동제3투,"창동초등학교(1층, 연수실)",서울특별시 도봉구 해등로16길 81(창동),2702,1276,483,740,6,13,4,4,0,7,3,0,2,5,1267,9,1426
717,Dobong,투표소,CH5,창5동제4투,"창5동주민센터(2층, 교양강좌실)",서울특별시 도봉구 도봉로136나길 20(창동),2581,1134,417,652,8,19,0,5,0,11,5,0,1,2,1120,14,1447
718,Dobong,투표소,CH5,창5동제5투,북한산아이파크 경로당(1층),서울특별시 도봉구 도봉로136길 28(창동),1596,967,234,695,4,12,0,1,0,8,1,0,0,5,960,7,629
719,Dobong,투표소,CH5,창5동제6투,"북한산아이파크 516동(지하1층, 입주자대표회의실)",서울특별시 도봉구 도봉로136길 28(창동),2411,1340,378,920,6,14,1,2,0,9,1,1,0,4,1336,4,1071
720,Dobong,투표소,CH5,창5동제7투,"창5동주민센터(4층, 대강당)",서울특별시 도봉구 도봉로136나길 20(창동),2057,741,284,415,7,7,1,1,0,15,2,2,0,3,737,4,1316
721,Dobong,투표소,DB1,도봉1동제1투,"도봉1동주민센터(3층, 대강당)",서울특별시 도봉구 도봉로169나길 22(도봉동),2632,946,373,537,6,13,2,1,0,5,2,0,1,1,941,5,1686
722,Dobong,투표소,DB1,도봉1동제2투,"도봉고등학교(1층, 과학교실1)",서울특별시 도봉구 도봉산길 27(도봉동),3729,1838,719,1035,9,26,1,3,2,7,11,1,2,4,1820,18,1891
723,Dobong,투표소,DB1,도봉1동제3투,"북서울중학교 해오름관(1층, 학생회의실)",서울특별시 도봉구 도봉로169가길 33(도봉동),1970,838,320,487,2,14,0,3,0,2,0,0,1,5,834,4,1132
724,Dobong,투표소,DB1,도봉1동제4투,"도봉초등학교(1층, 과학실)",서울특별시 도봉구 도봉로173길 96(도봉동),1378,539,179,332,3,8,2,1,0,2,4,1,0,3,535,4,839
725,Dobong,투표소,DB1,도봉1동제5투,럭키아파트 경로당(1층),서울특별시 도봉구 도봉로169길 31(도봉동),2356,1173,405,726,4,16,1,0,0,7,2,1,1,1,1164,9,1183
726,Dobong,투표소,DB1,도봉1동제6투,"오봉초등학교(1층, 교직원식당)",서울특별시 도봉구 시루봉로 285(도봉동),3600,1490,558,855,11,20,1,5,0,14,5,1,2,3,1475,15,2110
727,Dobong,투표소,DB2,도봉2동제1투,"도봉2동주민센터(3층, 다목적실)",서울특별시 도봉구 마들로 668(도봉동),2010,765,299,438,2,11,1,3,1,3,2,1,0,1,762,3,1245
728,Dobong,투표소,DB2,도봉2동제2투,"도봉역 1번 출구 옆 공유부엌 달그락(1층, 1호)","서울특별시 도봉구 도봉로170길 2(도봉동, 도봉역 1번 출구 옆)",2486,1291,442,808,5,12,1,0,0,9,2,0,0,2,1281,10,1195
729,Dobong,투표소,DB2,도봉2동제3투,"도봉중학교 예지관(1층, 스포츠동아리실)",서울특별시 도봉구 마들로 671(도봉동),2304,891,379,475,4,14,0,1,2,2,3,1,0,2,883,8,1413
730,Dobong,투표소,DB2,도봉2동제4투,"서원아파트 제1경로당(1층, 할아버지방)",서울특별시 도봉구 마들로 684-19(도봉동),2436,1132,501,581,3,14,2,3,0,12,3,1,0,2,1122,10,1304
731,Dobong,투표소,DB2,도봉2동제5투,"르노삼성자동차 도봉사업소(1층, 로비)",서울특별시 도봉구 도봉로180길 17(도봉동),3722,1919,727,1100,13,24,6,4,0,20,3,1,2,12,1912,7,1803
732,Dobong,투표소,DB2,도봉2동제6투,"누원초등학교(1층, 강당)",서울특별시 도봉구 마들로 859-44(도봉동),3287,1900,732,1102,4,19,0,0,0,13,3,0,1,11,1885,15,1387
733,Dobong,투표소,DB2,도봉2동제7투,한신아파트 경로당(1층),서울특별시 도봉구 마들로 859-19(도봉동),3601,2141,812,1252,11,25,1,4,1,10,3,1,1,5,2126,15,1460
734,Nowon,투표소,WK1,월계1동제1투,"월계1동주민센터(2층, 다용도방)",서울특별시 노원구 석계로 59(월계동),2858,1287,458,774,10,22,1,0,0,3,1,0,1,3,1273,14,1571
735,Nowon,투표소,WK1,월계1동제2투,현대아파트 경로당(1층),"서울특별시 노원구 석계로 49(월계동, 현대아파트)",2331,1183,445,691,3,14,1,6,0,5,8,0,0,4,1177,6,1148
736,Nowon,투표소,WK1,월계1동제3투,"선곡초등학교(1층, 보건교육실)",서울특별시 노원구 광운로2길 1(월계동),3723,1684,584,1016,10,23,1,6,1,19,3,0,0,2,1665,19,2039
737,Nowon,투표소,WK1,월계1동제4투,"(구) 노원영어마을(1층, 강당)",서울특별시 노원구 석계로 91(월계동),3306,1389,511,815,6,18,1,2,0,11,3,0,1,5,1373,16,1917
738,Nowon,투표소,WK1,월계1동제5투,"광운전자공업고등학교 근면관(1층, 현관)",서울특별시 노원구 광운로1길 24(월계동),2921,1253,459,734,6,19,2,3,0,11,4,1,1,5,1245,8,1668
739,Nowon,투표소,WK2,월계2동제1투,"월계2동주민센터(3층, 다목적방)",서울특별시 노원구 초안산로5길 28(월계동),3471,1492,576,857,6,24,0,5,0,5,5,0,0,2,1480,12,1979
740,Nowon,투표소,WK2,월계2동제2투,"월계중학교(1층, 기술실)",서울특별시 노원구 월계로45가길 54(월계동),2678,1144,480,613,8,19,0,2,1,11,5,0,0,2,1141,3,1534
741,Nowon,투표소,WK2,월계2동제3투,"월계초등학교(1층, 과학실)",서울특별시 노원구 월계로45가길 10(월계동),2804,1473,521,910,4,11,1,0,0,8,2,0,0,5,1462,11,1331
742,Nowon,투표소,WK2,월계2동제4투,"신창중학교(1층, 도서실)",서울특별시 노원구 월계로45길 92(월계동),3906,1826,721,1023,5,22,2,3,0,15,12,0,1,8,1812,14,2080
743,Nowon,투표소,WK2,월계2동제5투,"월계종합사회복지관(1층, 로비)",서울특별시 노원구 초안산로1길 51(월계동),2822,1338,510,776,5,12,0,4,0,1,8,1,3,2,1322,16,1484
744,Nowon,투표소,WK2,월계2동제6투,"월계문화정보도서관(1층, 현관)",서울특별시 노원구 월계로 319(월계동),2873,1330,467,806,7,17,2,1,0,10,7,2,1,2,1322,8,1543
745,Nowon,투표소,WK3,월계3동제1투,미성경로당(1층),서울특별시 노원구 마들로 59(월계동),2159,1026,383,600,6,9,0,4,0,3,7,0,2,4,1018,8,1133
746,Nowon,투표소,WK3,월계3동제2투,이박사삼호체육관(1층),서울특별시 노원구 마들로 111(월계동),2572,1447,552,831,4,27,2,3,0,10,9,0,0,4,1442,5,1125
747,Nowon,투표소,WK3,월계3동제3투,"한내행복발전소(3층, 다목적실)",서울특별시 노원구 마들로3길 13(월계동),2473,1280,481,759,1,9,0,1,0,8,11,0,0,2,1272,8,1193
748,Nowon,투표소,WK3,월계3동제4투,"녹천초등학교(1층, 녹천관 로비)",서울특별시 노원구 마들로3길 34(월계동),2635,1332,596,669,7,13,4,1,0,10,11,0,1,5,1317,15,1303
749,Nowon,투표소,WK3,월계3동제5투,"그랑빌경로당(1층, 할아버지방)",서울특별시 노원구 마들로 31(월계동),3179,1973,706,1194,7,23,1,2,0,18,5,0,1,6,1963,10,1206
750,Nowon,투표소,WK3,월계3동제6투,"한천초등학교(1층, 다목적실)",서울특별시 노원구 마들로 45(월계동),3076,1897,640,1176,7,23,2,7,1,12,5,2,1,9,1885,12,1179
751,Nowon,투표소,WK3,월계3동제7투,"그랑빌경로당(1층, 할머니방)",서울특별시 노원구 마들로 31(월계동),1733,902,344,523,2,12,2,2,0,10,1,0,1,1,898,4,831
752,Nowon,투표소,WK3,월계3동제8투,"연지초등학교(1층, 1-1반)",서울특별시 노원구 월계로55길 48(월계동),1799,751,309,416,3,9,2,4,0,2,2,1,1,1,750,1,1048
753,Nowon,투표소,WK3,월계3동제9투,"녹천중학교 본관(1층, 현관로비)",서울특별시 노원구 월계로 376(월계동),1944,825,316,471,4,14,0,0,0,3,3,1,0,1,813,12,1119
754,Nowon,투표소,KR1,공릉1동제1투,"공릉1동주민센터(3층, 다목적방)",서울특별시 노원구 동일로186길 3-24(공릉동),3463,1238,476,682,10,14,1,5,0,24,2,0,1,10,1225,13,2225
755,Nowon,투표소,KR1,공릉1동제2투,"서울공릉초등학교 도담관(2층, 체육관)",서울특별시 노원구 동일로173길 12(공릉동),4031,1816,687,1008,16,22,6,11,2,35,8,2,0,5,1802,14,2215
756,Nowon,투표소,KR1,공릉1동제3투,"공릉1동주민센터(2층, 주민사랑방)",서울특별시 노원구 동일로186길 3-24(공릉동),3361,1161,452,620,7,11,2,6,0,24,9,1,2,8,1142,19,2200
757,Nowon,투표소,KR1,공릉1동제4투,"공릉행복발전소(1층, 경로당)",서울특별시 노원구 동일로179길 22(공릉동),2741,1252,486,702,2,26,0,2,0,5,8,1,0,6,1238,14,1489
758,Nowon,투표소,KR1,공릉1동제5투,"공릉종합사회복지관(1층, 경로당)","서울특별시 노원구 동일로 1127(공릉동, 공릉1단지아파트)",2379,1180,475,656,6,22,2,2,0,4,2,1,0,6,1176,4,1199
759,Nowon,투표소,KR1,공릉1동제6투,"공릉2단지아파트 관리사무소(1층, 경로당)","서울특별시 노원구 동일로198가길 149(공릉동, 공릉2단지아파트)",1833,893,316,527,1,18,0,5,0,10,4,1,1,3,886,7,940
760,Nowon,투표소,KR1,공릉1동제7투,"서울공연초등학교(1층, 실과실)",서울특별시 노원구 동일로192가길 16(공릉동),2759,1314,516,739,10,17,1,3,0,8,4,1,1,4,1304,10,1445
761,Nowon,투표소,KR1,공릉1동제8투,"노원문화원(1층, 다목적공연장)",서울특별시 노원구 동일로197길 24(공릉동),2780,1339,554,734,2,11,2,0,1,12,2,0,1,5,1324,15,1441
762,Nowon,투표소,KR1,공릉1동제9투,"서울용원초등학교(1층, 푸른교실)",서울특별시 노원구 섬밭로 144(공릉동),2959,1588,676,859,4,16,1,4,0,4,7,0,0,4,1575,13,1371
763,Nowon,투표소,KR2,공릉2동제1투,"공릉2동주민센터(1층, 쉼터)",서울특별시 노원구 노원로1길 68(공릉동),3234,1388,570,744,6,19,3,4,0,20,4,0,0,7,1377,11,1846
764,Nowon,투표소,KR2,공릉2동제2투,우방아파트 경로당(1층),"서울특별시 노원구 노원로 58(공릉동, 우방아파트)",3259,1802,676,1055,13,15,1,5,0,15,2,1,1,5,1789,13,1457
765,Nowon,투표소,KR2,공릉2동제3투,동신아파트 경로당(1층),"서울특별시 노원구 공릉로 213(공릉동, 동신아파트)",3748,1895,704,1073,18,35,3,4,0,20,11,0,0,5,1873,22,1853
766,Nowon,투표소,KR2,공릉2동제4투,태강아파트 경로당(1층),"서울특별시 노원구 공릉로34길 62(공릉동, 태강아파트)",1952,1010,401,547,6,12,2,6,0,11,13,0,0,3,1001,9,942
767,Nowon,투표소,KR2,공릉2동제5투,삼익1차아파트 경로당(1층),"서울특별시 노원구 공릉로46길 32(공릉동, 삼익아파트)",3288,1767,690,1017,5,15,2,1,0,15,4,0,1,9,1759,8,1521
768,Nowon,투표소,KR2,공릉2동제6투,"공릉보건지소(지하1층, 보건교육실)",서울특별시 노원구 공릉로 166-1(공릉동),3082,1478,545,848,9,21,0,6,0,11,7,0,1,7,1455,23,1604
769,Nowon,투표소,KR2,공릉2동제7투,"공릉어르신복지센터(1층, 경로당)",서울특별시 노원구 공릉로 129(공릉동),3169,1434,571,786,14,13,1,0,0,17,8,1,0,8,1419,15,1735
770,Nowon,투표소,KR2,공릉2동제8투,"태랑중학교(1층, 2-1반)",서울특별시 노원구 화랑로51나길 51(공릉동),1458,717,200,461,5,4,0,1,0,30,2,0,0,9,712,5,741
771,Nowon,투표소,KR2,공릉2동제9투,공릉아파트 경로당(1층),"서울특별시 노원구 화랑로51길 81(공릉동, 공릉아파트)",2292,1200,480,684,3,10,1,2,0,3,6,0,0,5,1194,6,1092
772,Nowon,투표소,HK1,하계1동제1투,"하계중학교(1층, 정보관음악1실)",서울특별시 노원구 노원로 261-8(하계동),2405,1150,396,713,3,16,0,3,0,8,1,0,1,3,1144,6,1255
773,Nowon,투표소,HK1,하계1동제2투,"불암중학교(1층, 체육관동 시청각실)",서울특별시 노원구 한글비석로5길 45(하계동),2656,1239,519,659,5,14,1,6,2,11,2,1,1,2,1223,16,1417
774,Nowon,투표소,HK1,하계1동제3투,"하계종합사회복지관(1층, 탁구장)",서울특별시 노원구 노원로16길 15(하계동),3233,1509,552,901,5,23,2,2,0,7,6,0,0,4,1502,7,1724
775,Nowon,투표소,HK1,하계1동제4투,한청경로당(1층),서울특별시 노원구 공릉로 351(하계동),3160,1668,601,1006,11,13,2,5,0,15,2,0,0,5,1660,8,1492
776,Nowon,투표소,HK1,하계1동제5투,"연촌초등학교(1층, 로비)",서울특별시 노원구 공릉로58길 36(하계동),3197,1319,506,737,13,17,0,3,0,13,6,1,0,8,1304,15,1878
777,Nowon,투표소,HK1,하계1동제6투,"청솔아파트 관리사무소(1층, 회의실)",서울특별시 노원구 공릉로59길 25(하계동),3397,1953,780,1090,8,26,2,4,0,20,6,0,0,8,1944,9,1444
778,Nowon,투표소,HK2,하계2동제1투,"하계2동주민센터(2층, 다목적방)",서울특별시 노원구 공릉로55길 88(하계동),2832,1298,507,736,4,11,0,3,0,16,2,0,0,6,1285,13,1534
779,Nowon,투표소,HK2,하계2동제2투,"중현초등학교(1층, 다목적실)",서울특별시 노원구 섬밭로 181(하계동),2066,855,378,454,5,9,1,1,1,1,0,1,1,3,855,0,1211
780,Nowon,투표소,HK2,하계2동제3투,"현우경로당(1층, 현대우성아파트 내)",서울특별시 노원구 섬밭로 232(하계동),3486,2199,829,1277,15,30,1,3,0,20,5,0,1,6,2187,12,1287
781,Nowon,투표소,HK2,하계2동제4투,"중평초등학교(1층, 체육관[어울채])",서울특별시 노원구 섬밭로 241(하계동),2992,1536,626,854,14,5,1,3,0,19,4,0,0,5,1531,5,1456
782,Nowon,투표소,HK2,하계2동제5투,"중평중학교(1층, 가정실)",서울특별시 노원구 동일로203길 87(하계동),3166,1738,688,995,9,14,0,6,0,11,1,0,0,4,1728,10,1428
783,Nowon,투표소,JKB,중계본동제1투,"중계본동주민센터(지하1층, 탁구장)",서울특별시 노원구 중계로 143(중계동),1861,909,292,584,8,6,2,2,0,6,0,0,0,1,901,8,952
784,Nowon,투표소,JKB,중계본동제2투,"중계마을복지회관(1층, 동아리방)",서울특별시 노원구 중계로6나길 39(중계동),661,196,70,123,0,0,1,1,0,0,0,0,0,0,195,1,465
785,Nowon,투표소,JKB,중계본동제3투,"불암도서관(지하1층,플랫폼B)",서울특별시 노원구 중계로 106(중계동),2723,1348,540,750,4,17,2,2,0,12,1,0,1,11,1340,8,1375
786,Nowon,투표소,JKB,중계본동제4투,"수암초등학교(1층, 현관로비)",서울특별시 노원구 중계로12길 9(중계동),3152,1616,714,834,11,15,2,5,0,12,2,1,0,5,1601,15,1536
787,Nowon,투표소,JKB,중계본동제5투,"불암고등학교(1층, 도서관)",서울특별시 노원구 중계로 155(중계동),2883,1363,522,777,12,14,2,5,1,9,5,0,0,5,1352,11,1520
788,Nowon,투표소,JKB,중계본동제6투,"불암초등학교(1층, 체육관)",서울특별시 노원구 중계로 178(중계동),3089,1669,624,971,12,21,4,3,0,9,3,1,0,7,1655,14,1420
789,Nowon,투표소,JK1,중계1동제1투,"중계1동주민센터(지하1층, 탁구장)",서울특별시 노원구 한글비석로 279(중계동),2923,1369,533,774,13,19,0,2,0,10,7,2,0,6,1366,3,1554
790,Nowon,투표소,JK1,중계1동제2투,"원광초등학교(1층, 원광초 학부모회)",서울특별시 노원구 덕릉로76길 18(중계동),3191,1500,634,807,8,14,2,2,0,11,3,1,0,5,1487,13,1691
791,Nowon,투표소,JK1,중계1동제3투,"청암중고등학교(본관1층, 과학실)",서울특별시 노원구 중계로 244(중계동),2806,1446,600,779,8,17,2,4,1,10,3,1,1,8,1434,12,1360
792,Nowon,투표소,JK1,중계1동제4투,"서울을지초등학교(1층, 1-7반)",서울특별시 노원구 중계로 239(중계동),3203,1649,626,959,12,6,3,7,0,15,1,0,0,7,1636,13,1554
793,Nowon,투표소,JK1,중계1동제5투,"서라벌고등학교(1층, 송덕도서관)",서울특별시 노원구 한글비석로5길 18(중계동),2871,1494,531,911,6,14,1,3,0,11,4,1,1,5,1488,6,1377
794,Nowon,투표소,JK2·3,중계2·3동제1투,"노원구민회관(3층, 교육장)",서울특별시 노원구 동일로 1229(중계동),2736,1246,538,657,3,16,1,2,0,14,1,0,0,4,1236,10,1490
795,Nowon,투표소,JK2·3,중계2·3동제2투,"노원구민회관(1층, 레크레이션실)",서울특별시 노원구 동일로 1229(중계동),2802,1601,632,910,5,14,1,5,0,20,2,1,0,4,1594,7,1201
796,Nowon,투표소,JK2·3,중계2·3동제3투,"중원초등학교(1층, 현관 로비)",서울특별시 노원구 섬밭로 316(중계동),2290,1214,495,651,8,17,0,10,0,15,6,1,0,3,1206,8,1076
797,Nowon,투표소,JK2·3,중계2·3동제4투,"서울아이티고등학교 믿음관(1층, 도토실)",서울특별시 노원구 섬밭로 299(중계동),2470,1172,522,599,6,13,1,2,2,10,4,0,1,6,1166,6,1298
798,Nowon,투표소,JK2·3,중계2·3동제5투,"중계2·3동주민센터(2층, 다목적실)",서울특별시 노원구 노원로17길 56(중계동),2636,1088,420,611,4,20,1,7,0,12,3,0,0,6,1084,4,1548
799,Nowon,투표소,JK2·3,중계2·3동제6투,"청계초등학교(2층, 도담관)",서울특별시 노원구 공릉로 431(중계동),2409,1100,440,598,8,20,2,3,0,17,1,2,0,5,1096,4,1309
800,Nowon,투표소,JK2·3,중계2·3동제7투,"마들사회복지관(1층, 식당)","서울특별시 노원구 동일로210길 22(중계동, 중계주공1단지아파트)",2130,1202,489,653,9,19,3,4,2,5,2,1,3,5,1195,7,928
801,Nowon,투표소,JK2·3,중계2·3동제8투,"중원중학교(1층, 가사실)",서울특별시 노원구 공릉로 420(중계동),2353,1027,422,555,10,17,2,0,0,5,1,1,3,2,1018,9,1326
802,Nowon,투표소,JK2·3,중계2·3동제9투,"평화종합사회복지관(1층, 식당)","서울특별시 노원구 노원로 331(중계동, 시영3단지목련아파트)",1678,894,368,486,11,7,0,1,1,1,3,0,2,4,884,10,784
803,Nowon,투표소,JK2·3,중계2·3동제10투,목화아파트 경로당(1층),서울특별시 노원구 노원로19길31(중계동),2705,1217,511,662,3,16,3,3,0,4,4,1,0,1,1208,9,1488
804,Nowon,투표소,JK4,중계4동제1투,"중계4동주민센터(1층, 민원실)",서울특별시 노원구 덕릉로82길 50(중계동),3493,1621,705,857,7,24,0,3,0,6,1,1,0,8,1612,9,1872
805,Nowon,투표소,JK4,중계4동제2투,"중계종합사회복지관(1층, 경로식당)","서울특별시 노원구 덕릉로 662(중계동, 주공3단지아파트)",2523,1140,432,659,6,10,0,4,1,4,2,1,2,7,1128,12,1383
806,Nowon,투표소,JK4,중계4동제3투,"서울중계초등학교(1층, 다목적실)",서울특별시 노원구 한글비석로19길 39(중계동),3880,2076,801,1193,12,17,1,10,1,19,5,1,1,8,2069,7,1804
807,Nowon,투표소,JK4,중계4동제4투,"상계제일중학교(1층, 시청각실 로비)",서울특별시 노원구 덕릉로86길 29-15(중계동),3330,1515,585,884,6,13,0,3,0,10,3,1,0,3,1508,7,1815
808,Nowon,투표소,SK1,상계1동제1투,"상계1동주민센터(5층, 다목적실)",서울특별시 노원구 동일로 1697(상계동),3897,1402,573,770,5,18,2,4,0,12,3,1,0,6,1394,8,2495
809,Nowon,투표소,SK1,상계1동제2투,"수락초등학교(1층, 방과후교실)",서울특별시 노원구 동일로 1745(상계동),2999,1292,516,726,4,18,0,3,0,6,5,1,0,8,1287,5,1707
810,Nowon,투표소,SK1,상계1동제3투,은빛2단지아파트 경로당(1층),"서울특별시 노원구 동일로245가길 41(상계동, 은빛2단지아파트)",3567,1742,768,883,4,29,3,4,0,21,4,0,1,8,1725,17,1825
811,Nowon,투표소,SK1,상계1동제4투,"수락중학교(1층, 교직원식당)",서울특별시 노원구 동일로 1729(상계동),3147,1509,487,965,7,15,3,4,1,7,2,1,2,7,1501,8,1638
812,Nowon,투표소,SK1,상계1동제5투,"노일중학교(1층, 체육동아리실)",서울특별시 노원구 동일로231길 24(상계동),3337,1582,677,841,6,21,2,1,0,11,2,0,1,8,1570,12,1755
813,Nowon,투표소,SK1,상계1동제6투,"노일초등학교(1층, 과학1실)",서울특별시 노원구 동일로 1625(상계동),3133,1557,623,869,3,25,0,1,0,17,3,1,0,5,1547,10,1576
814,Nowon,투표소,SK1,상계1동제7투,극동늘푸른아파트 경로당(1층),"서울특별시 노원구 동일로246길 39(상계동, 극동늘푸른아파트)",3090,1580,581,954,5,13,0,2,0,7,3,1,0,4,1570,10,1510
815,Nowon,투표소,SK1,상계1동제8투,"노원초등학교(2층, 체육관)",서울특별시 노원구 동일로230나길 32(상계동),3518,1748,694,979,8,18,0,3,1,20,6,0,0,2,1731,17,1770
816,Nowon,투표소,SK2,상계2동제1투,"상계2동주민센터(4층, 대강당)",서울특별시 노원구 상계로 118(상계동),3316,1348,488,801,8,21,4,1,1,10,0,0,0,5,1339,9,1968
817,Nowon,투표소,SK2,상계2동제2투,"상계초등학교(1층, 중앙복도)",서울특별시 노원구 상계로9길 39(상계동),3345,1404,493,844,12,20,0,1,0,15,1,1,1,3,1391,13,1941
818,Nowon,투표소,SK2,상계2동제3투,"상계중학교(1층, 협력학습실)",서울특별시 노원구 노원로 398(상계동),3336,1363,570,727,15,16,2,3,0,12,2,0,0,5,1352,11,1973
819,Nowon,투표소,SK2,상계2동제4투,"상계중학교(1층, 동아리실)",서울특별시 노원구 노원로 398(상계동),3267,1579,589,915,14,18,1,3,0,17,1,0,1,4,1563,16,1688
820,Nowon,투표소,SK3·4,상계3·4동제1투,"신상계초등학교(2층, 체육관중앙)",서울특별시 노원구 상계로 267(상계동),3814,1551,628,862,6,23,2,2,0,5,6,1,0,5,1540,11,2263
821,Nowon,투표소,SK3·4,상계3·4동제2투,상계불암대림아파트 경로당(1층),서울특별시 노원구 덕릉로94길 21(상계동),2813,1629,617,962,10,13,3,4,0,6,4,0,0,4,1623,6,1184
822,Nowon,투표소,SK3·4,상계3·4동제3투,동아불암아파트 경로당(1층),"서울특별시 노원구 덕릉로 780(상계동, 동아불암아파트)",2547,1325,556,719,6,12,1,2,0,11,4,0,0,3,1314,11,1222
823,Nowon,투표소,SK3·4,상계3·4동제4투,"상계종합사회복지관(2층, 대강당)",서울특별시 노원구 덕릉로115나길 25(상계동),2054,877,340,499,1,14,0,2,0,6,0,3,0,6,871,6,1177
824,Nowon,투표소,SK3·4,상계3·4동제5투,"덕암초등학교(1층, 현관로비)",서울특별시 노원구 덕릉로112길 68(상계동),2622,1362,481,832,3,14,0,1,1,10,6,0,1,4,1353,9,1260
825,Nowon,투표소,SK3·4,상계3·4동제6투,"상계3·4동주민센터(지하1층, 다목적실)",서울특별시 노원구 덕릉로 859(상계동),2727,886,369,490,4,11,1,2,0,4,0,0,1,1,883,3,1841
826,Nowon,투표소,SK3·4,상계3·4동제7투,"상계3·4동주민센터(2층, 다용도실)",서울특별시 노원구 덕릉로 859(상계동),2420,897,361,498,4,14,3,3,0,2,2,0,0,4,891,6,1523
827,Nowon,투표소,SK5,상계5동제1투,"상계5동주민센터(2층, 다목적방)",서울특별시 노원구 한글비석로 432(상계동),2680,984,356,588,6,14,3,1,0,3,2,0,0,6,979,5,1696
828,Nowon,투표소,SK5,상계5동제2투,"벽산아파트 관리사무소(1층, 회의실)","서울특별시 노원구 한글비석로 396(상계동, 벽산아파트)",3258,1586,600,916,8,20,1,2,0,13,5,2,0,6,1573,13,1672
829,Nowon,투표소,SK5,상계5동제3투,"서울계상초등학교(1층, 1-1반)",서울특별시 노원구 한글비석로41가길 24(상계동),2601,1053,397,621,3,15,0,0,0,5,1,2,1,3,1048,5,1548
830,Nowon,투표소,SK5,상계5동제4투,"한신2차아파트 관리사무소(1층, 경로당)","서울특별시 노원구 한글비석로48길 6(상계동, 한신2차아파트)",3136,1482,586,833,6,20,2,1,0,15,3,0,0,3,1469,13,1654
831,Nowon,투표소,SK5,상계5동제5투,"한신1차아파트 관리사무소(1층, 경로당)","서울특별시 노원구 한글비석로46가길 16(상계동, 한신1차아파트)",2691,1291,500,735,6,23,2,1,0,7,5,0,3,3,1285,6,1400
832,Nowon,투표소,SK5,상계5동제6투,"대림아파트 관리사무소(2층, 경로당)","서울특별시 노원구 상계로 193-14(상계동, 상계대림아파트)",2887,1344,486,804,5,17,0,4,0,8,1,0,1,5,1331,13,1543
833,Nowon,투표소,SK6·7,상계6·7동제1투,"상계고등학교 북관(1층, 화학실험실)",서울특별시 노원구 노해로 432(상계동),2981,1469,451,962,10,23,1,2,0,6,4,0,0,4,1463,6,1512
834,Nowon,투표소,SK6·7,상계6·7동제2투,"노원중학교 본관(1층, 협력종합예술실)",서울특별시 노원구 동일로213길 26(상계동),3112,1590,594,936,7,11,1,3,0,20,4,0,1,5,1582,8,1522
835,Nowon,투표소,SK6·7,상계6·7동제3투,"당현초등학교 정보체육관(1층, 체육관 영어전용교실)",서울특별시 노원구 동일로213길 52(상계동),3071,1581,596,925,11,18,1,5,0,18,0,0,1,1,1576,5,1490
836,Nowon,투표소,SK6·7,상계6·7동제4투,"상천초등학교 체육관(1층, 체육관 현관)",서울특별시 노원구 덕릉로 443(상계동),3782,2024,827,1120,10,23,2,3,0,14,7,0,1,5,2012,12,1758
837,Nowon,투표소,SK6·7,상계6·7동제5투,상계주공6단지 경로당(1층),"서울특별시 노원구 노해로 508(상계동, 상계주공6단지아파트)",3548,1883,670,1131,12,17,2,5,0,18,6,0,0,3,1864,19,1665
838,Nowon,투표소,SK6·7,상계6·7동제6투,"신상중학교 본관(1층, 사회실)",서울특별시 노원구 동일로216길 42(상계동),3295,1512,566,884,7,17,0,5,1,16,3,0,0,7,1506,6,1783
839,Nowon,투표소,SK6·7,상계6·7동제7투,한양아파트 경로당(1층),"서울특별시 노원구 동일로216길 92(상계동, 한양아파트)",3201,1901,704,1117,10,25,2,4,0,16,3,0,1,4,1886,15,1300
840,Nowon,투표소,SK8,상계8동제1투,"상계8동주민센터(지하1층, 탁구장)",서울특별시 노원구 동일로227길 97(상계동),2562,1243,460,731,6,10,3,3,0,14,6,0,0,7,1240,3,1319
841,Nowon,투표소,SK8,상계8동제2투,상계주공10단지아파트 경로당(1층),"서울특별시 노원구 노원로 564(상계동, 상계주공10단지아파트)",3049,1602,691,848,9,14,0,5,0,9,2,0,0,8,1586,16,1447
842,Nowon,투표소,SK8,상계8동제3투,상계주공11단지아파트 경로당(1층),"서울특별시 노원구 동일로227길 25(상계동, 상계주공11단지아파트)",2889,1363,479,835,3,18,2,4,0,10,2,0,1,2,1356,7,1526
843,Nowon,투표소,SK8,상계8동제4투,"상경중학교(1층, 스마트교실1)",서울특별시 노원구 동일로227길 61(상계동),2168,840,426,383,1,14,2,0,0,3,1,0,0,3,833,7,1328
844,Nowon,투표소,SK8,상계8동제5투,상계주공16단지아파트 경로당(1층),"서울특별시 노원구 동일로227길 86(상계동, 상계주공16단지아파트)",2907,1555,582,908,12,14,2,1,0,9,3,1,0,9,1541,14,1352
845,Nowon,투표소,SK9,상계9동제1투,"상계9동주민센터(2층, 다용도방)",서울특별시 노원구 한글비석로 487(상계동),3083,1429,509,852,6,20,4,5,0,13,4,2,0,4,1419,10,1654
846,Nowon,투표소,SK9,상계9동제2투,보람아파트 경로당(1층),"서울특별시 노원구 한글비석로 479(상계동, 보람아파트1단지)",3307,1713,604,1033,6,24,0,7,0,13,2,1,0,4,1694,19,1594
847,Nowon,투표소,SK9,상계9동제3투,"상원초등학교(1층, 멀티미디어실)",서울특별시 노원구 한글비석로54길 119(상계동),3092,1440,502,862,10,18,3,6,0,10,8,0,1,7,1427,13,1652
848,Nowon,투표소,SK9,상계9동제4투,상계주공14단지아파트 경로당(1층),"서울특별시 노원구 동일로228길 23(상계동, 상계주공14단지아파트)",3655,1814,711,1025,11,19,3,1,1,17,5,0,0,4,1797,17,1841
849,Nowon,투표소,SK10,상계10동제1투,"상계10동주민센터(지하1층, 다목적방)",서울특별시 노원구 노원로 530(상계동),2847,1448,463,914,6,17,4,3,0,18,2,0,0,9,1436,12,1399
850,Nowon,투표소,SK10,상계10동제2투,상계주공7단지아파트 경로당(1층),서울특별시 노원구 동일로 1456(상계동),2874,1398,504,839,7,15,1,3,0,15,0,1,2,2,1389,9,1476
851,Nowon,투표소,SK10,상계10동제3투,"서울상곡초등학교 체육관(1층, 로비)",서울특별시 노원구 노원로38길 34(상계동),3199,1604,584,943,7,27,3,3,0,15,5,0,0,5,1592,12,1595
852,Nowon,투표소,SK10,상계10동제4투,상계주공9단지아파트 경로당(1층),서울특별시 노원구 노원로 532(상계동),2801,1333,484,796,12,15,1,2,0,9,3,0,1,2,1325,8,1468
853,Eunpyeong,투표소,NB,녹번동제1투,"은평구사회적경제허브센터(3층, 교육실)",서울특별시 은평구 은평로 245(녹번동),3575,1327,543,704,7,24,1,3,0,13,4,0,0,9,1308,19,2248
854,Eunpyeong,투표소,NB,녹번동제2투,"은평초등학교 후관동(1층, 제2과학실)",서울특별시 은평구 은평로 239(녹번동),3757,1842,634,1138,4,12,1,7,0,17,3,1,1,12,1830,12,1915
855,Eunpyeong,투표소,NB,녹번동제3투,"녹번초등학교(1층, 과학1실)",서울특별시 은평구 녹번로1길 1(녹번동),3426,1278,537,694,7,10,0,3,0,7,4,0,1,7,1270,8,2148
856,Eunpyeong,투표소,NB,녹번동제4투,"녹번동주민센터(3층, 다목적실)",서울특별시 은평구 은평로 195(녹번동),3286,1258,505,695,12,21,2,5,0,6,5,0,0,3,1254,4,2028
857,Eunpyeong,투표소,NB,녹번동제5투,"혁신파크 상상청(1층, 전시실)",서울특별시 은평구 통일로 684(녹번동),3917,1984,743,1160,13,19,2,2,0,20,3,0,1,7,1970,14,1933
858,Eunpyeong,투표소,NB,녹번동제6투,"녹번초등학교(1층, 과학2실)",서울특별시 은평구 녹번로1길 1(녹번동),3613,1371,533,775,11,21,0,6,1,6,5,1,0,3,1362,9,2242
859,Eunpyeong,투표소,NB,녹번동제7투,"은평구립 우리장애인종합복지관(1층, 로비)",서울특별시 은평구 녹번로1길 13(녹번동),3620,1439,602,769,5,26,2,2,0,11,6,0,2,3,1428,11,2181
860,Eunpyeong,투표소,EA1,응암제1동제1투,"응암제1동주민센터(3층, 다목적실)",서울특별시 은평구 백련산로 179(응암동),3346,1278,554,658,14,26,1,4,1,10,2,0,3,4,1277,1,2068
861,Eunpyeong,투표소,EA1,응암제1동제2투,"꿈나무마을 초록꿈터(1층, 강당)",서울특별시 은평구 백련산로14길 20-11(응암동),1326,483,174,289,3,7,0,1,0,2,0,0,0,2,478,5,843
862,Eunpyeong,투표소,EA1,응암제1동제3투,"(구)은평등기소(1층, 별관)",서울특별시 은평구 백련산로 178(응암동),3141,1304,532,702,9,22,1,9,1,10,3,1,1,5,1296,8,1837
863,Eunpyeong,투표소,EA1,응암제1동제4투,"은명초등학교(1층, 중앙현관)",서울특별시 은평구 은평로4길 21-9(응암동),3824,1638,724,837,17,19,1,10,1,9,1,1,0,8,1628,10,2186
864,Eunpyeong,투표소,EA1,응암제1동제5투,"신진과학기술고등학교(1층, 세미나실)",서울특별시 은평구 은평로6길 16(응암동),4707,1857,848,888,13,21,6,6,0,29,13,0,1,20,1845,12,2850
865,Eunpyeong,투표소,EA1,응암제1동제6투,"녹번역e편한세상캐슬 커뮤니티센터1(1층, 라운지카페)","서울특별시 은평구 은평로 220(응암동, 녹번역e편한세상캐슬아파트)",4033,2369,920,1362,7,33,4,9,1,14,2,1,0,10,2363,6,1664
866,Eunpyeong,투표소,EA2,응암제2동제1투,"응암제2동주민센터(1층, 북카페)",서울특별시 은평구 백련산로 100(응암동),4049,1577,680,838,10,12,1,4,0,12,1,0,0,9,1567,10,2472
867,Eunpyeong,투표소,EA2,응암제2동제2투,"백련산SK뷰아이파크아파트(1층, 경로당)","서울특별시 은평구 응암로30길 16(응암동, 백련산SK뷰아이파크)",3197,1657,715,874,7,22,0,3,0,18,1,0,1,5,1646,11,1540
868,Eunpyeong,투표소,EA2,응암제2동제3투,"백련산힐스테이트 제2차아파트(지하1층, 경로당)","서울특별시 은평구 백련산로 38(응암동, 백련산 힐스테이트 2차)",3238,1559,633,874,9,11,3,1,0,7,3,0,0,9,1550,9,1679
869,Eunpyeong,투표소,EA2,응암제2동제4투,"백련산힐스테이트 제3차아파트(1층, 주민커뮤니티센터)","서울특별시 은평구 백련산로 36(응암동, 백련산 힐스테이트 3차)",3345,1670,682,940,7,16,2,2,0,9,1,0,0,4,1663,7,1675
870,Eunpyeong,투표소,EA2,응암제2동제5투,"서서울농협(3층, 강당)",서울특별시 은평구 응암로 242-2(응암동),3434,1479,619,793,11,23,0,5,0,5,2,1,0,4,1463,16,1955
871,Eunpyeong,투표소,EA3,응암제3동제1투,"응암제3동주민센터(4층, 다목적실)",서울특별시 은평구 불광천길 410-17(응암동),3466,1207,518,620,14,19,2,1,0,13,6,0,0,5,1198,9,2259
872,Eunpyeong,투표소,EA3,응암제3동제2투,"은평문화예술정보학교 창의인성교육센터(1층, 북카페)",서울특별시 은평구 가좌로 208(응암동),3271,1181,485,643,11,14,0,2,1,7,5,0,0,2,1170,11,2090
873,Eunpyeong,투표소,EA3,응암제3동제3투,"은평문화예술정보학교 창의인성교육센터(2층, 세미나실)",서울특별시 은평구 가좌로 208(응암동),3444,1256,547,632,15,16,4,3,0,6,4,0,1,13,1241,15,2188
874,Eunpyeong,투표소,EA3,응암제3동제4투,"응암초등학교 후관(지하1층, 실버경찰준비실)",서울특별시 은평구 가좌로6길 20(응암동),2281,794,323,437,0,12,1,2,0,3,1,1,1,2,783,11,1487
875,Eunpyeong,투표소,EA3,응암제3동제5투,"구립응암정보도서관(1층, 자료실)",서울특별시 은평구 가좌로7길 15(응암동),2541,1133,446,636,6,17,1,2,0,8,2,1,2,2,1123,10,1408
876,Eunpyeong,투표소,EA3,응암제3동제6투,"충암경로당(1층, 할머니방)",서울특별시 은평구 가좌로7길 9-15(응암동),2923,1267,582,619,11,13,2,0,0,10,8,0,0,8,1253,14,1656
877,Eunpyeong,투표소,JS,증산동제1투,"증산동주민센터(4층, 다목적실)",서울특별시 은평구 증산서길 89(증산동),2660,1227,486,687,11,18,1,2,1,7,3,0,0,4,1220,7,1433
878,Eunpyeong,투표소,JS,증산동제2투,"연서중학교(1층, 과학실)",서울특별시 은평구 증산서길 125-6(증산동),3292,1454,561,818,11,21,2,6,0,12,4,2,0,5,1442,12,1838
879,Eunpyeong,투표소,JS,증산동제3투,"증산초등학교 스포츠센터(1층, 로비)",서울특별시 은평구 증산서길 61(증산동),2369,1080,411,626,6,12,0,1,0,4,3,0,0,2,1065,15,1289
880,Eunpyeong,투표소,JS,증산동제4투,"증산중학교 별관(1층, 과학실)",서울특별시 은평구 증산로5길 27-30(증산동),1451,686,249,409,4,7,1,2,0,4,0,0,0,4,680,6,765
881,Eunpyeong,투표소,SS,수색동제1투,"수색동주민센터(2층, 휴카페)",서울특별시 은평구 수색로 280(수색동),2317,1056,395,617,9,14,0,3,0,7,1,1,0,4,1051,5,1261
882,Eunpyeong,투표소,SS,수색동제2투,"수색동주민센터(2층, 휴카페)",서울특별시 은평구 수색로 280(수색동),2432,1122,379,712,2,10,2,1,0,8,1,0,0,2,1117,5,1310
883,Eunpyeong,투표소,SS,수색동제3투,"대림한숲타운아파트(1층, 관리사무소내 경로당)","서울특별시 은평구 은평터널로 65(수색동, 대림한숲타운아파트)",2577,1424,516,846,10,21,7,2,0,12,0,0,1,5,1420,4,1153
884,Eunpyeong,투표소,SS1,신사제1동제1투,"신사제1동주민센터(3층, 다목적실)",서울특별시 은평구 은평로2길 2(신사동),3811,1474,597,778,17,28,3,5,0,16,9,3,0,6,1462,12,2337
885,Eunpyeong,투표소,SS1,신사제1동제2투,"신사종합사회복지관(1층, 카페)",서울특별시 은평구 은평로 38(신사동),3650,1515,658,764,15,16,6,3,0,16,6,1,0,10,1495,20,2135
886,Eunpyeong,투표소,SS1,신사제1동제3투,"서울기독대학교(1층, 정보학술도서관)",서울특별시 은평구 갈현로4길 26-2(신사동),3853,1573,670,818,14,20,3,3,0,20,5,1,0,6,1560,13,2280
887,Eunpyeong,투표소,SS1,신사제1동제4투,"덕산중학교(2층, 체육관)",서울특별시 은평구 가좌로 400(신사동),2905,1042,427,566,6,13,3,5,0,6,2,0,1,5,1034,8,1863
888,Eunpyeong,투표소,SS1,신사제1동제5투,"덕산중학교(2층, 체육관)",서울특별시 은평구 가좌로 400(신사동),3773,1680,665,935,8,31,1,2,1,11,5,0,1,7,1667,13,2093
889,Eunpyeong,투표소,SS2,신사제2동제1투,"신사초등학교(1층, 다목적실)",서울특별시 은평구 가좌로 275-2(신사동),2699,1112,447,611,7,13,3,4,0,12,4,3,0,2,1106,6,1587
890,Eunpyeong,투표소,SS2,신사제2동제2투,"서신초등학교(2층, 로비)",서울특별시 은평구 은평터널로 150(신사동),3011,1246,514,662,2,23,7,6,0,7,4,1,0,10,1236,10,1765
891,Eunpyeong,투표소,SS2,신사제2동제3투,"상신초등학교(1층, 다목적실)",서울특별시 은평구 가좌로 361(신사동),3222,1221,521,641,13,16,3,2,0,8,2,0,0,7,1213,8,2001
892,Eunpyeong,투표소,SS2,신사제2동제4투,"서신초등학교(1층, 로비)",서울특별시 은평구 은평터널로 150(신사동),2534,1086,450,583,8,17,2,1,0,10,1,0,0,7,1079,7,1448
893,Eunpyeong,투표소,SS2,신사제2동제5투,"신사제2동주민센터(4층, 강당)",서울특별시 은평구 증산로15길 47(신사동),2623,1123,463,616,6,15,4,2,0,5,2,0,0,3,1116,7,1500
894,Eunpyeong,투표소,KH2,갈현제2동제1투,"갈현제2동주민센터(3층, 다목적실)",서울특별시 은평구 연서로27길 31-6(갈현동),4072,1501,595,791,19,35,0,4,0,20,5,2,1,9,1481,20,2571
895,Eunpyeong,투표소,KH2,갈현제2동제2투,"은평장애인자립생활센터(1층, 프로그램실)","서울특별시 은평구 연서로 149,107호(갈현동, 동광갈현베르빌)",4202,1777,712,969,14,28,3,7,2,14,7,0,0,10,1766,11,2425
896,Eunpyeong,투표소,KH2,갈현제2동제3투,"선정고등학교(1층, 체육관 좌측)",서울특별시 은평구 서오릉로20길 19(갈현동),4044,1444,599,759,10,22,3,3,0,18,7,1,2,12,1436,8,2600
897,Eunpyeong,투표소,KH2,갈현제2동제4투,"선정고등학교(1층, 체육관 우측)",서울특별시 은평구 서오릉로20길 19(갈현동),3995,1593,698,815,16,23,2,9,1,7,2,1,0,7,1581,12,2402
898,Eunpyeong,투표소,KH2,갈현제2동제5투,"갈현초등학교 신관동(1층, 교과수업실1)",서울특별시 은평구 연서로29길 31(갈현동),3545,1496,617,794,12,26,2,1,1,17,2,1,0,9,1482,14,2049
899,Eunpyeong,투표소,KS,구산동제1투,"구산동주민센터(3층, 다목적실)",서울특별시 은평구 갈현로17길 10(구산동),4015,1478,588,805,14,19,0,2,0,16,9,0,3,9,1465,13,2537
900,Eunpyeong,투표소,KS,구산동제2투,"예일여자고등학교 독보기념관(1층, 로비)",서울특별시 은평구 연서로 117(구산동),4601,1922,821,974,28,26,6,3,0,23,8,0,1,14,1904,18,2679
901,Eunpyeong,투표소,KS,구산동제3투,"서부재활체육센터(1층, 로비)",서울특별시 은평구 갈현로11길 30(구산동),3251,1306,558,642,15,24,2,8,0,7,2,4,0,15,1277,29,1945
902,Eunpyeong,투표소,KS,구산동제4투,"구산중학교 본관(1층, 회의실)",서울특별시 은평구 갈현로15길 20-23(구산동),2585,983,426,510,5,16,0,1,0,6,5,0,0,6,975,8,1602
903,Eunpyeong,투표소,KS,구산동제5투,"구산초등학교 거북관(1층, 로비)",서울특별시 은평구 서오릉로15길 16(구산동),3866,1618,643,891,17,26,1,5,0,12,3,1,0,9,1608,10,2248
904,Eunpyeong,투표소,KS,구산동제6투,"갈현현대아파트 관리사무소(1층, 회의실)","서울특별시 은평구 서오릉로21길 36(구산동, 갈현현대아파트)",3643,1609,633,901,11,24,3,4,0,13,4,1,1,6,1601,8,2034
905,Eunpyeong,투표소,KH1,갈현제1동제1투,"갈현제1동주민센터(2층, 마을활력소)",서울특별시 은평구 갈현로 301(갈현동),2687,1011,390,559,9,22,2,2,1,3,7,0,1,8,1004,7,1676
906,Eunpyeong,투표소,KH1,갈현제1동제2투,"갈현청소년센터 쉼쉼(지하1층, 강당)",서울특별시 은평구 통일로89길 6-20(갈현동),2455,842,314,468,9,21,0,5,0,13,2,1,1,1,835,7,1613
907,Eunpyeong,투표소,KH1,갈현제1동제3투,"신도고등학교(1층, 회의실)",서울특별시 은평구 통일로 961(진관동),3275,1218,458,686,7,25,1,1,1,15,7,1,2,6,1210,8,2057
908,Eunpyeong,투표소,KH1,갈현제1동제4투,"갈현노인복지관(4층, 강당)",서울특별시 은평구 통일로89길 12-6(갈현동),3777,1423,555,780,13,23,3,8,1,14,7,0,0,11,1415,8,2354
909,Eunpyeong,투표소,KH1,갈현제1동제5투,"갈현초등학교(1층, 영어교실)",서울특별시 은평구 연서로29길 31(갈현동),3450,1398,586,739,8,19,2,6,0,12,6,2,0,5,1385,13,2052
910,Eunpyeong,투표소,JK,진관동제1투,"진관중학교(2층, 체육관)",서울특별시 은평구 진관4로 36(진관동),3049,1690,678,962,9,17,2,1,0,6,1,0,0,3,1679,11,1359
911,Eunpyeong,투표소,JK,진관동제2투,"진관초등학교(1층, 한울채 식당)",서울특별시 은평구 진관4로 78-16(진관동),3363,1961,755,1137,14,21,4,1,0,9,2,0,0,9,1952,9,1402
912,Eunpyeong,투표소,JK,진관동제3투,"진관초등학교 매화동(1층, 로비)",서울특별시 은평구 진관4로 78-16(진관동),2771,1443,550,829,14,14,1,4,0,5,2,0,1,8,1428,15,1328
913,Eunpyeong,투표소,JK,진관동제4투,"진관동주민센터(2층, 기쁨홀)",서울특별시 은평구 진관2로 31(진관동),3098,1512,582,879,5,10,0,5,0,9,2,0,0,8,1500,12,1586
914,Eunpyeong,투표소,JK,진관동제5투,"한국고전번역원(1층, 원사자료실)",서울특별시 은평구 진관1로 85(진관동),2655,1386,572,759,7,19,3,3,0,10,1,0,0,4,1378,8,1269
915,Eunpyeong,투표소,JK,진관동제6투,"은평메디텍고등학교(1층, 행정실 로비)",서울특별시 은평구 진관2로 57-57(진관동),3116,1669,555,1055,9,13,5,2,1,8,4,0,1,10,1663,6,1447
916,Eunpyeong,투표소,JK,진관동제7투,"은평메디텍고등학교(1층, 보건실 로비)",서울특별시 은평구 진관2로 57-57(진관동),2566,1280,425,808,10,12,1,3,0,5,2,0,1,5,1272,8,1286
917,Eunpyeong,투표소,JK,진관동제8투,"신도중학교 본관(1층, 로비)",서울특별시 은평구 진관1로 77-30(진관동),2849,1624,622,943,9,13,2,1,0,10,4,0,1,7,1612,12,1225
918,Eunpyeong,투표소,JK,진관동제9투,"은빛초등학교(1층, 모두배움터)",서울특별시 은평구 진관3로 73-17(진관동),3725,1918,856,992,8,19,2,6,0,19,2,0,0,5,1909,9,1807
919,Eunpyeong,투표소,JK,진관동제10투,"은빛초등학교(1층, 은빛쉼터)",서울특별시 은평구 진관3로 73-17(진관동),3483,1723,798,820,19,18,3,6,0,17,7,1,0,12,1701,22,1760
920,Eunpyeong,투표소,JK,진관동제11투,"진관동주민센터(3층, 지혜교실)",서울특별시 은평구 진관2로 31(진관동),3732,1104,445,575,13,12,4,4,0,22,2,1,0,11,1089,15,2628
921,Eunpyeong,투표소,BK1,불광제1동제1투,"불광제1동주민센터(4층, 다목적실)",서울특별시 은평구 진흥로15길 10(불광동),3259,1302,490,727,10,20,2,5,0,23,3,0,0,11,1291,11,1957
922,Eunpyeong,투표소,BK1,불광제1동제2투,"북한산현대홈타운아파트(1층, 108동 서예교실)","서울특별시 은평구 불광로2길 16(불광동, 북한산현대홈타운아파트)",3872,2091,789,1226,10,22,2,2,0,16,5,2,0,8,2082,9,1781
923,Eunpyeong,투표소,BK1,불광제1동제3투,"불광초등학교(1층, 체육관)",서울특별시 은평구 불광로 51(불광동),3071,1332,562,692,8,23,1,2,0,15,7,1,2,6,1319,13,1739
924,Eunpyeong,투표소,BK1,불광제1동제4투,"라이프미성아파트(1층, 정문 경비초소 옆 노상주차장)","서울특별시 은평구 통일로 780(불광동, 미성아파트)",2587,1663,496,1098,7,25,1,7,0,12,0,1,1,3,1651,12,924
925,Eunpyeong,투표소,BK1,불광제1동제5투,"수리초등학교(1층, 체육관)",서울특별시 은평구 불광로14길 10-10(불광동),3912,2005,813,1095,8,20,2,5,0,16,9,2,1,15,1986,19,1907
926,Eunpyeong,투표소,BK1,불광제1동제6투,"삼익아파트(1층, 주차장)","서울특별시 은평구 불광로 153(불광동, 삼익아파트)",3038,1463,618,769,11,26,3,2,0,13,2,0,3,5,1452,11,1575
927,Eunpyeong,투표소,BK1,불광제1동제7투,"북한산힐스테이트7차아파트(1층, 관리동주민공동시설)","서울특별시 은평구 통일로 796(불광동, 북한산 힐스테이트7차)",4626,2222,830,1285,20,27,2,4,0,16,8,0,1,12,2205,17,2404
928,Eunpyeong,투표소,BK1,불광제1동제8투,"은평구불광보건분소(1층, 다목적실)",서울특별시 은평구 연서로34길 11(불광동),3284,1506,664,767,13,19,1,7,0,14,7,1,1,6,1500,6,1778
929,Eunpyeong,투표소,BK2,불광제2동제1투,"연신초등학교(1층, 체육관)",서울특별시 은평구 연서로 347(불광동),2567,1000,370,582,5,17,3,3,0,2,2,0,0,9,993,7,1567
930,Eunpyeong,투표소,BK2,불광제2동제2투,"연천중학교(1층, 음악실)",서울특별시 은평구 연서로41길 30(불광동),3064,1172,519,580,8,35,0,5,0,11,2,0,0,4,1164,8,1892
931,Eunpyeong,투표소,BK2,불광제2동제3투,"세명컴퓨터고등학교(1층, 본관로비)",서울특별시 은평구 통일로92가길 33(불광동),3250,1135,471,603,8,21,0,1,0,16,4,2,0,2,1128,7,2115
932,Eunpyeong,투표소,BK2,불광제2동제4투,"연신중학교 신관(1층, 가사교실)",서울특별시 은평구 연서로33길 16-32(불광동),2622,982,368,570,8,10,3,1,0,12,1,1,0,3,977,5,1640
933,Eunpyeong,투표소,BK2,불광제2동제5투,"연신중학교(1층, 본관로비)",서울특별시 은평구 연서로33길 16-32(불광동),2954,1232,463,708,8,21,1,1,1,8,4,0,0,9,1224,8,1722
934,Eunpyeong,투표소,BK2,불광제2동제6투,"불광보건분소(4층, 건강증진실)",서울특별시 은평구 연서로34길 11(불광동),2715,1239,526,655,3,22,2,4,1,11,0,0,0,5,1229,10,1476
935,Eunpyeong,투표소,BK2,불광제2동제7투,"불광중학교(1층, 소강당)",서울특별시 은평구 불광로 180(불광동),3029,1354,570,709,6,24,0,6,0,12,0,0,0,14,1341,13,1675
936,Eunpyeong,투표소,DJ,대조동제1투,"대조동주민센터(2층, 다목적실)",서울특별시 은평구 연서로20길 24-3(대조동),4581,1702,699,889,21,30,0,12,0,20,5,0,0,9,1685,17,2879
937,Eunpyeong,투표소,DJ,대조동제2투,"대조초등학교(1층, 체육관 동측)",서울특별시 은평구 연서로18길 17(대조동),4133,1511,618,806,11,27,2,5,0,17,5,1,1,11,1504,7,2622
938,Eunpyeong,투표소,DJ,대조동제3투,"동명여자고등학교(본관1층, 로비)",서울특별시 은평구 통일로 793(대조동),2658,1094,455,581,8,20,2,3,0,9,3,0,0,6,1087,7,1564
939,Eunpyeong,투표소,DJ,대조동제4투,"은평새마을금고 대조동지점(2층, 회의실)",서울특별시 은평구 통일로69길 31(대조동),949,337,149,175,0,3,1,0,0,3,1,0,0,2,334,3,612
940,Eunpyeong,투표소,DJ,대조동제5투,"대조동 늘봄장애인자립생활센터(3층, 프로그램실)",서울특별시 은평구 불광로 7(대조동),3560,1364,546,727,12,25,1,5,0,15,7,0,1,11,1350,14,2196
941,Eunpyeong,투표소,DJ,대조동제6투,"대조초등학교(1층, 체육관 서측)",서울특별시 은평구 연서로18길 17(대조동),3629,1442,596,781,7,15,4,2,0,9,6,0,0,10,1430,12,2187
942,Eunpyeong,투표소,YCH,역촌동제1투,"역촌초등학교(1층, 5-2반)",서울특별시 은평구 은평로3길 25(역촌동),3664,1239,534,630,10,15,0,5,0,16,6,1,0,9,1226,13,2425
943,Eunpyeong,투표소,YCH,역촌동제2투,"역촌초등학교(1층, 5-1반)",서울특별시 은평구 은평로3길 25(역촌동),3656,1541,656,798,11,22,5,7,1,10,5,1,0,12,1528,13,2115
944,Eunpyeong,투표소,YCH,역촌동제3투,"역촌노인복지관(2층, 학습교육실)",서울특별시 은평구 연서로3나길 11-30(역촌동),3564,1390,621,694,6,18,3,6,0,16,4,0,2,8,1378,12,2174
945,Eunpyeong,투표소,YCH,역촌동제4투,"역촌노인복지관(지하1층, 식당)",서울특별시 은평구 연서로3나길 11-30(역촌동),3629,1331,586,686,6,23,0,5,0,8,3,0,0,8,1325,6,2298
946,Eunpyeong,투표소,YCH,역촌동제5투,"역촌동주민센터(2층, 다목적실)",서울특별시 은평구 연서로 59(역촌동),2967,1121,461,595,11,22,4,1,0,12,3,0,1,5,1115,6,1846
947,Eunpyeong,투표소,YCH,역촌동제6투,"은평구평생학습관(2층, 채움실1)",서울특별시 은평구 서오릉로 87(역촌동),2759,1187,468,664,3,17,2,3,0,7,2,0,2,9,1177,10,1572
948,Eunpyeong,투표소,YCH,역촌동제7투,"은평구평생학습관(3층, 채움실2)",서울특별시 은평구 서오릉로 87(역촌동),3256,1295,550,689,8,18,0,4,0,7,4,2,0,4,1286,9,1961
949,Eunpyeong,투표소,YCH,역촌동제8투,"은평구청소년문화의집 신나는애프터센터(1층, 카페)",서울특별시 은평구 연서로6길 7(역촌동),3830,1556,692,769,10,30,0,8,0,14,4,0,0,15,1542,14,2274
950,Eunpyeong,투표소,YCH,역촌동제9투,"월드비전 꿈빛마을(2층, 강당)",서울특별시 은평구 진흥로5길 10(역촌동),4398,1822,786,912,18,27,3,7,1,21,11,0,2,13,1801,21,2576
951,Seodaemun,투표소,CHH,충현동제1투,"충현동주민센터(2층, 대회의실)",서울특별시 서대문구 북아현로22길 38(북아현동),2858,1162,416,681,11,10,0,1,0,10,9,0,2,10,1150,12,1696
952,Seodaemun,투표소,CHH,충현동제2투,"충현동주민센터(지하1층, 주차장)",서울특별시 서대문구 북아현로22길 38(북아현동),2482,1064,403,613,5,19,0,5,0,2,6,0,0,7,1060,4,1418
953,Seodaemun,투표소,CHH,충현동제3투,"추계예술대학교(1층, 후문 청사관휴게실)",서울특별시 서대문구 북아현로11가길 7(북아현동),2762,1466,510,897,5,18,2,4,0,9,6,0,2,5,1458,8,1296
954,Seodaemun,투표소,CHH,충현동제4투,"충현동자치회관(3층, 다목적실)",서울특별시 서대문구 경기대로 40(충정로3가),3071,1450,602,763,12,20,1,5,1,19,6,0,0,11,1440,10,1621
955,Seodaemun,투표소,CHH,충현동제5투,"미동초등학교(1층, 미술실)",서울특별시 서대문구 충정로 52(미근동),2869,1323,531,720,10,18,6,5,0,16,3,1,0,3,1313,10,1546
956,Seodaemun,투표소,CHY,천연동제1투,"천연동주민센터(2층, 다목적실)",서울특별시 서대문구 성산로 694(영천동),2422,1147,362,721,12,15,0,2,0,8,7,0,0,15,1142,5,1275
957,Seodaemun,투표소,CHY,천연동제2투,"동명여자중학교(1층, 동아리실)",서울특별시 서대문구 독립문로 49(천연동),2717,1325,545,715,10,18,1,4,0,6,9,0,1,8,1317,8,1392
958,Seodaemun,투표소,CHY,천연동제3투,"금화초등학교(1층, 신관 도서관 꿈빛샘터)",서울특별시 서대문구 통일로 165(천연동),2464,1223,488,681,5,15,4,3,0,10,3,0,0,9,1218,5,1241
959,Seodaemun,투표소,CHY,천연동제4투,"한성과학고등학교(1층, 창조관)",서울특별시 서대문구 통일로 279-79(현저동),539,294,138,143,3,1,1,0,0,3,0,0,0,4,293,1,245
960,Seodaemun,투표소,CHY,천연동제5투,"독립문극동아파트(1층, 경로당)","서울특별시 서대문구 독립문공원길 17(현저동, 독립문극동아파트)",3000,1811,633,1110,6,16,1,6,1,5,2,0,0,13,1793,18,1189
961,Seodaemun,투표소,BAH,북아현동제1투,"북아현동주민센터(3층, 문화사랑방 303호)",서울특별시 서대문구 북아현로 24(북아현동),2123,902,337,530,4,7,1,1,0,5,1,0,1,9,896,6,1221
962,Seodaemun,투표소,BAH,북아현동제2투,"북아현동주민센터(4층, 강당)",서울특별시 서대문구 북아현로 24(북아현동),2291,964,365,552,6,11,1,4,0,6,3,1,1,5,955,9,1327
963,Seodaemun,투표소,BAH,북아현동제3투,"한성고등학교(1층, 구내식당)",서울특별시 서대문구 북아현로1길 24(북아현동),3055,1457,531,861,8,17,1,6,0,11,3,0,0,11,1449,8,1598
964,Seodaemun,투표소,BAH,북아현동제4투,"e편한세상신촌아파트(1층, 203동 멀티룸)","서울특별시 서대문구 북아현로1길 17(북아현동, e편한세상신촌 2단지)",3132,1591,466,1050,8,14,5,5,0,16,1,0,0,18,1583,8,1541
965,Seodaemun,투표소,SCH,신촌동제1투,"숲속 한방랜드(1층, 공용실)",서울특별시 서대문구 봉원사길 75-7(봉원동),2096,931,262,591,17,9,0,1,0,21,5,0,0,11,917,14,1165
966,Seodaemun,투표소,SCH,신촌동제2투,"서울대신초등학교 (1층, 신관 주차장)",서울특별시 서대문구 이화여대2길 27(대현동),4026,1769,507,1100,41,11,6,3,1,45,3,0,1,27,1745,24,2257
967,Seodaemun,투표소,SCH,신촌동제3투,신촌동자치회관(1층),서울특별시 서대문구 연세로2나길 47(창천동),2695,1007,305,601,17,12,4,4,1,19,4,0,0,21,988,19,1688
968,Seodaemun,투표소,SCH,신촌동제4투,"서울창서초등학교 (2층, 초등돌봄교실복도)",서울특별시 서대문구 연세로5나길 30-3(창천동),3105,1122,329,686,15,13,9,3,0,20,4,1,0,11,1091,31,1983
969,Seodaemun,투표소,SCH,신촌동제5투,"서울창서초등학교 (1층, 행정실복도)",서울특별시 서대문구 연세로5나길 30-3(창천동),2912,1037,376,567,14,12,3,6,0,14,6,0,0,19,1017,20,1875
970,Seodaemun,투표소,YH,연희동제1투,"연희동주민센터(3층, 다목적실)",서울특별시 서대문구 연희로 189(연희동),3341,1338,453,818,11,17,5,0,0,13,2,0,1,10,1330,8,2003
971,Seodaemun,투표소,YH,연희동제2투,"연희동자치회관(3층, 다목적실)",서울특별시 서대문구 증가로 13-10(연희동),2125,1094,372,662,13,12,4,1,0,6,2,0,0,14,1086,8,1031
972,Seodaemun,투표소,YH,연희동제3투,"서연중학교(본관 2층, 3-4교실)",서울특별시 서대문구 연희로11마길 9-6(연희동),2912,1244,431,751,9,3,5,3,0,17,3,0,0,13,1235,9,1668
973,Seodaemun,투표소,YH,연희동제4투,"연희노인여가복지시설(4층, 강당)",서울특별시 서대문구 홍제천로2길 111(연희동),1867,836,386,404,9,9,2,1,0,5,2,0,1,7,826,10,1031
974,Seodaemun,투표소,YH,연희동제5투,"연희파크푸르지오아파트(지하1층, 관리사무소 옆 주민회의실)","서울특별시 서대문구 홍제천로 136(연희동, 연희파크푸르지오)",2841,1459,631,753,15,17,3,3,0,8,2,1,1,17,1451,8,1382
975,Seodaemun,투표소,YH,연희동제6투,"서대문구 평생학습관 융복합인재교육센터(서대문구의회)(지하1층, 드론＆자율주행실)",서울특별시 서대문구 연희로36길 49(연희동),2766,1187,466,653,16,12,4,0,1,11,1,1,0,11,1176,11,1579
976,Seodaemun,투표소,YH,연희동제7투,"연희초등학교(2층, 다목적강당)",서울특별시 서대문구 연희로 136(연희동),3074,1376,436,856,11,12,4,3,0,14,6,0,1,19,1362,14,1698
977,Seodaemun,투표소,YH,연희동제8투,"연희초등학교(2층, 다목적강당)",서울특별시 서대문구 연희로 136(연희동),3706,1562,466,945,30,18,5,9,0,25,6,0,0,31,1535,27,2144
978,Seodaemun,투표소,YH,연희동제9투,"연세대학교재활학교(1층, 로비)",서울특별시 서대문구 연세로 50(신촌동),3206,1410,492,811,12,16,1,3,1,20,7,1,1,28,1393,17,1796
979,Seodaemun,투표소,HJ1,홍제제1동제1투,"서울예술실용전문학교(1층, A동 104호강의실)",서울특별시 서대문구 통일로37길 60(홍제동),2577,1225,551,609,5,18,0,5,0,14,5,0,0,5,1212,13,1352
980,Seodaemun,투표소,HJ1,홍제제1동제2투,"하하호호홍제마을활력소(1층, 다목적실)",서울특별시 서대문구 통일로 483(홍은동),2861,1643,607,956,11,26,1,5,0,7,13,1,0,3,1630,13,1218
981,Seodaemun,투표소,HJ1,홍제제1동제3투,"홍제행복기숙사(1층, 대회의실)",서울특별시 서대문구 송죽길 62(홍제동),2717,1440,619,766,2,16,1,0,0,4,8,0,0,13,1429,11,1277
982,Seodaemun,투표소,HJ1,홍제제1동제4투,"디지털서울문화예술대학교(1층,H동 102호 소극장)",서울특별시 서대문구 통일로37길 51(홍제동),2239,1117,483,568,12,16,3,2,0,6,9,1,0,8,1108,9,1122
983,Seodaemun,투표소,HJ1,홍제제1동제5투,"고은초등학교(1층, 영어전용실)",서울특별시 서대문구 모래내로 441(홍제동),2743,1438,550,816,10,19,0,1,0,12,12,1,0,5,1426,12,1305
984,Seodaemun,투표소,HJ1,홍제제1동제6투,"홍제제1동자치회관(5층, 강당)",서울특별시 서대문구 통일로27길 19(홍제동),2336,1193,432,698,4,14,5,3,0,12,5,0,0,13,1186,7,1143
985,Seodaemun,투표소,HJ1,홍제제1동제7투,"서울안산초등학교(1층, 실과실)",서울특별시 서대문구 통일로 321(홍제동),1183,690,243,412,4,7,4,3,0,1,1,0,0,5,680,10,493
986,Seodaemun,투표소,HJ2,홍제제2동제1투,"홍제커뮤니티센터(2층, 다목적실)",서울특별시 서대문구 통일로36다길 2(홍제동),2048,868,361,458,6,14,1,3,0,4,4,0,0,2,853,15,1180
987,Seodaemun,투표소,HJ2,홍제제2동제2투,"인왕어르신복지센터(2층, 강당)",서울특별시 서대문구 통일로26길 12-5(홍제동),2723,1503,523,919,10,10,1,6,1,9,2,0,1,9,1491,12,1220
988,Seodaemun,투표소,HJ2,홍제제2동제3투,"홍제제2동주민센터(4층, 대강당)",서울특별시 서대문구 통일로34길 27(홍제동),2148,1137,393,681,7,16,1,3,0,10,7,0,0,7,1125,12,1011
989,Seodaemun,투표소,HJ2,홍제제2동제4투,"인왕산현대아파트 상가(지하1층, 지하주차장)",서울특별시 서대문구 통일로34길 48(홍제동),2044,1093,407,623,5,22,4,3,0,6,8,0,0,8,1086,7,951
990,Seodaemun,투표소,HJ3,홍제제3동제1투,"홍제제3동주민센터(2층, 멀티학습실)",서울특별시 서대문구 세검정로4길 32(홍제동),2352,916,391,491,3,14,2,0,0,2,3,0,0,3,909,7,1436
991,Seodaemun,투표소,HJ3,홍제제3동제2투,"홍은초등학교 (1층, 동관 녹색어머니실)",서울특별시 서대문구 세검정로 105(홍제동),2575,1179,496,635,12,11,2,2,0,4,4,0,0,5,1171,8,1396
992,Seodaemun,투표소,HJ3,홍제제3동제3투,"홍제배드민턴장(1층, 내부순환로 홍은진입램프 고가 아래)",서울특별시 서대문구 홍제동280-9(홍제동),2687,1227,499,670,10,10,5,1,0,14,2,1,0,3,1215,12,1460
993,Seodaemun,투표소,HJ3,홍제제3동제4투,인왕초등학교 정보관(4층 멀티미디어실),서울특별시 서대문구 세무서길 33-9(홍제동),2895,1340,555,724,5,13,3,4,1,18,3,2,3,2,1333,7,1555
994,Seodaemun,투표소,HE1,홍은제1동제1투,"홍은제1동주민센터(지하1층, 강당)",서울특별시 서대문구 홍은중앙로 85(홍은동),1602,620,278,296,8,16,3,1,0,5,2,0,0,4,613,7,982
995,Seodaemun,투표소,HE1,홍은제1동제2투,"홍제초등학교(1층, 나래반)",서울특별시 서대문구 홍은중앙로 13(홍은동),3345,1720,695,956,15,14,2,3,0,11,6,0,0,9,1711,9,1625
996,Seodaemun,투표소,HE1,홍은제1동제3투,"홍제초등학교(1층, 아름반)",서울특별시 서대문구 홍은중앙로 13(홍은동),2745,1453,546,841,9,14,4,4,0,13,4,0,0,6,1441,12,1292
997,Seodaemun,투표소,HE1,홍은제1동제4투,"동일아파트(1층, 주차장)","서울특별시 서대문구 홍은중앙로 81(홍은동, 동일아파트)",2000,971,378,550,4,15,4,1,0,8,2,0,0,4,966,5,1029
998,Seodaemun,투표소,HE1,홍은제1동제5투,"홍은도담도서관(3층, 열람실)",서울특별시 서대문구 홍은중앙로 129(홍은동),2748,1343,544,726,8,19,5,3,1,10,2,1,2,8,1329,14,1405
999,Seodaemun,투표소,HE1,홍은제1동제6투,홍은제1동 제1공영주차장(지하1층),서울특별시 서대문구 포방터2길 10(홍은동),2509,1133,478,599,4,9,0,0,0,8,5,0,1,12,1116,17,1376
1000,Seodaemun,투표소,HE2,홍은제2동제1투,"서대문구치매안심센터(2층, 대강당)",서울특별시 서대문구 연희로 290(홍은동),3507,1227,489,675,10,15,2,4,0,9,4,0,0,8,1216,11,2280
1001,Seodaemun,투표소,HE2,홍은제2동제2투,"홍은중학교(2층, 체육관)",서울특별시 서대문구 연희로41길 94(홍은동),2488,1133,400,675,7,13,1,4,1,4,4,0,1,12,1122,11,1355
1002,Seodaemun,투표소,HE2,홍은제2동제3투,"홍은중학교(1층, 두레박실)",서울특별시 서대문구 연희로41길 94(홍은동),3565,1872,763,1013,5,31,4,3,1,7,10,1,3,15,1856,16,1693
1003,Seodaemun,투표소,HE2,홍은제2동제4투,"정원여자중학교(1층, 중앙홀)",서울특별시 서대문구 연희로37안길 51(홍은동),2850,1208,532,594,15,21,2,1,1,8,6,1,0,15,1196,12,1642
1004,Seodaemun,투표소,HE2,홍은제2동제5투,"홍은제2동주민센터(2층, 대강당)",서울특별시 서대문구 모래내로 334(홍은동),3232,1144,450,624,13,16,0,2,0,11,8,0,1,10,1135,9,2088
1005,Seodaemun,투표소,HE2,홍은제2동제6투,"명지전문대학 본관(4층, 426호)",서울특별시 서대문구 가좌로 134(홍은동),2930,1148,409,672,3,15,0,9,2,17,1,0,1,7,1136,12,1782
1006,Seodaemun,투표소,NKJ1,남가좌제1동제1투,"남가좌제1동주민센터(3층, 대강당)",서울특별시 서대문구 모래내로15길 37(남가좌동),2511,1236,389,796,6,18,1,2,0,9,4,1,0,2,1228,8,1275
1007,Seodaemun,투표소,NKJ1,남가좌제1동제2투,"DMC파크뷰자이아파트 1단지커뮤니티센터(1층, 경로당)","서울특별시 서대문구 가재울미래로 2(남가좌동, DMC파크뷰자이)",2273,1241,453,752,2,14,2,3,0,7,1,1,0,3,1238,3,1032
1008,Seodaemun,투표소,NKJ1,남가좌제1동제3투,"DMC파크뷰자이아파트 2단지커뮤니티센터(1층, 경로당)","서울특별시 서대문구 가재울미래로 2(남가좌동, DMC파크뷰자이)",2683,1412,533,820,7,9,5,3,1,8,4,0,0,6,1396,16,1271
1009,Seodaemun,투표소,NKJ1,남가좌제1동제4투,"시립서대문농아인복지관(지하1층, 회의실)",서울특별시 서대문구 수색로4가길 23(남가좌동),1719,803,271,500,6,8,0,1,0,4,1,0,0,3,794,9,916
1010,Seodaemun,투표소,NKJ2,남가좌제2동제1투,"남가좌제2동주민센터(3층, 대회의실)",서울특별시 서대문구 증가로10길 28(남가좌동),2647,1029,378,580,5,20,5,4,0,10,8,0,0,4,1014,15,1618
1011,Seodaemun,투표소,NKJ2,남가좌제2동제2투,"루마버텍스 (1층, 루마썬팅)",서울특별시 서대문구 증가로 103(남가좌동),2394,1090,482,549,5,19,0,3,1,15,3,0,0,4,1081,9,1304
1012,Seodaemun,투표소,NKJ2,남가좌제2동제3투,"남가좌동현대아파트(1층, 경로당)","서울특별시 서대문구 가재울로 45(남가좌동, 현대아파트)",2673,1424,479,889,8,22,1,2,0,9,1,2,0,5,1418,6,1249
1013,Seodaemun,투표소,NKJ2,남가좌제2동제4투,DMC에코자이아파트 자이안센터(1층),"서울특별시 서대문구 거북골로 84(남가좌동, DMC에코자이)",3173,1739,677,995,6,22,2,3,0,12,3,0,1,6,1727,12,1434
1014,Seodaemun,투표소,NKJ2,남가좌제2동제5투,"DMC래미안클라시스 103동 앞 탁구장(지하1층, 구. 남가좌삼성아파트)","서울특별시 서대문구 증가로 191(남가좌동, DMC래미안클라시스)",3408,1910,753,1078,15,16,2,0,0,23,3,2,0,8,1900,10,1498
1015,Seodaemun,투표소,NKJ2,남가좌제2동제6투,"명지대학교 경상관(1층, 4115 강의실)",서울특별시 서대문구 거북골로 34(남가좌동),2414,980,418,476,17,18,1,7,0,14,3,1,0,9,964,16,1434
1016,Seodaemun,투표소,NKJ2,남가좌제2동제7투,"연희중학교 정보관(1층, 기술가정실)",서울특별시 서대문구 증가로 170(남가좌동),2555,1156,402,710,4,7,5,4,0,9,0,0,1,7,1149,7,1399
1017,Seodaemun,투표소,BKJ1,북가좌제1동제1투,"북가좌제1동주민센터(2층, 문화교실2)",서울특별시 서대문구 수색로 100-55(북가좌동),2466,1227,438,744,5,16,1,3,0,9,1,0,0,3,1220,7,1239
1018,Seodaemun,투표소,BKJ1,북가좌제1동제2투,"북가좌초등학교(1층, 강당)",서울특별시 서대문구 거북골로19길 20(북가좌동),1912,803,309,460,5,10,1,1,0,8,1,0,0,3,798,5,1109
1019,Seodaemun,투표소,BKJ1,북가좌제1동제3투,"북가좌초등학교(1층, 강당)",서울특별시 서대문구 거북골로19길 20(북가좌동),2187,946,322,576,6,13,3,1,0,8,4,0,0,8,941,5,1241
1020,Seodaemun,투표소,BKJ1,북가좌제1동제4투,"DMC래미안e편한세상 1단지커뮤니티센터(1층, 키즈북카페)","서울특별시 서대문구 수색로 100(북가좌동, DMC래미안e편한세상)",2711,1473,477,938,9,14,2,3,1,10,4,0,0,7,1465,8,1238
1021,Seodaemun,투표소,BKJ1,북가좌제1동제5투,"DMC래미안e편한세상 3단지 커뮤니티센터(1층, 도서관)","서울특별시 서대문구 수색로 100(북가좌동, DMC래미안e편한세상)",1749,919,307,581,10,6,3,0,0,5,2,0,1,1,916,3,830
1022,Seodaemun,투표소,BKJ2,북가좌제2동제1투,"북가좌제2동주민센터(2층, 다목적실)",서울특별시 서대문구 응암로1길 10(북가좌동),3772,1506,657,776,11,14,3,1,0,19,4,1,1,7,1494,12,2266
1023,Seodaemun,투표소,BKJ2,북가좌제2동제2투,"서대문구청소년상담복지센터(1층, 휴먼센터 경로당)",서울특별시 서대문구 증가로30길 45-9(북가좌동),3234,1313,550,700,12,15,2,3,1,8,3,0,0,5,1299,14,1921
1024,Seodaemun,투표소,BKJ2,북가좌제2동제3투,"경원빌딩(지하1층, 지하주차장)",서울특별시 서대문구 응암로 60(북가좌동),2477,1122,468,602,7,17,1,3,1,4,1,2,0,6,1112,10,1355
1025,Seodaemun,투표소,BKJ2,북가좌제2동제4투,"가재울아이파크아파트(1층, 헬스클럽)","서울특별시 서대문구 거북골로14길 32(북가좌동, DMC아이파크아파트)",3083,1732,669,1000,9,17,3,4,0,8,4,0,0,9,1723,9,1351
1026,Seodaemun,투표소,BKJ2,북가좌제2동제5투,커피전문점 산맥,서울특별시 서대문구 증가로 213(북가좌동),2919,1294,570,663,11,19,0,3,0,6,3,2,0,5,1282,12,1625
1027,Seodaemun,투표소,BKJ2,북가좌제2동제6투,은가경로당(1층),서울특별시 서대문구 증가로20길 43(북가좌동),3384,1253,537,642,18,20,2,4,0,9,1,2,0,7,1242,11,2131
1028,Seodaemun,투표소,BKJ2,북가좌제2동제7투,서울상사(주) 택시미터,서울특별시 서대문구 증가로 204(북가좌동),3817,1636,734,825,9,20,1,3,0,13,6,0,1,11,1623,13,2181
1029,Mapo,투표소,KD,공덕동제1투,"아현실버복지관(5층, 강당)",서울특별시 마포구 환일길 3(아현동),3160,1443,595,785,9,18,1,3,1,10,3,2,0,4,1431,12,1717
1030,Mapo,투표소,KD,공덕동제2투,"마포구평생학습관 아현분관(2층, 시청각실)",서울특별시 마포구 마포대로 224(아현동),3650,1937,573,1284,7,15,5,4,0,15,9,0,0,14,1926,11,1713
1031,Mapo,투표소,KD,공덕동제3투,"소의초등학교(2층, 회의실)",서울특별시 마포구 마포대로24길 42(아현동),2457,963,379,528,4,18,1,3,0,15,1,1,0,3,953,10,1494
1032,Mapo,투표소,KD,공덕동제4투,공덕동1-2공영주차장(1층),서울특별시 마포구 만리재로14길 39(공덕동),2467,979,456,469,4,11,2,3,0,13,2,0,0,2,962,17,1488
1033,Mapo,투표소,KD,공덕동제5투,"원향고시원(지하1층, 주차장)",서울특별시 마포구 효창목길 23(공덕동),2837,1374,612,701,6,13,4,4,0,15,3,1,1,6,1366,8,1463
1034,Mapo,투표소,KD,공덕동제6투,"공덕동주민센터(2층, 강당)",서울특별시 마포구 만리재옛길 84(공덕동),2459,1104,429,612,4,11,0,0,1,20,4,3,0,9,1093,11,1355
1035,Mapo,투표소,KD,공덕동제7투,"공덕초등학교(1층, 체육관)",서울특별시 마포구 만리재옛길 13(공덕동),3086,1342,499,769,11,12,3,2,0,20,2,0,2,8,1328,14,1744
1036,Mapo,투표소,KD,공덕동제8투,"신공덕1차삼성아파트(1층, 경로당)","서울특별시 마포구 백범로37길 12(신공덕동, 신공덕1차삼성래미안아파트)",2949,1657,509,1076,7,16,1,4,0,18,5,0,0,8,1644,13,1292
1037,Mapo,투표소,KD,공덕동제9투,"마포문화원(4층, 강당)",서울특별시 마포구 백범로 227(신공덕동),3618,1872,612,1188,5,20,0,6,0,21,3,0,0,7,1862,10,1746
1038,Mapo,투표소,AH,아현동제1투,"아현동주민센터(지하1층, 체력단련실)",서울특별시 마포구 마포대로7길 18지하1층 체력단련실 (공덕동),2987,1333,402,878,4,10,3,1,0,19,1,0,0,5,1323,10,1654
1039,Mapo,투표소,AH,아현동제2투,"아현동주민센터(4층, 강당)",서울특별시 마포구 마포대로7길 18(공덕동),2275,1202,366,785,6,12,2,3,0,12,5,0,0,5,1196,6,1073
1040,Mapo,투표소,AH,아현동제3투,"래미안공덕5차아파트 커뮤니티센터(1층, 현관 로비)","서울특별시 마포구 마포대로 167(공덕동, 래미안 공덕5차)",2670,1452,462,938,4,11,2,6,0,9,1,0,0,6,1439,13,1218
1041,Mapo,투표소,AH,아현동제4투,"아현초등학교(1층, 실내체육장)",서울특별시 마포구 굴레방로 6(아현동),1663,776,256,484,5,7,3,2,0,7,1,0,0,4,769,7,887
1042,Mapo,투표소,AH,아현동제5투,"마포래미안푸르지오 2단지 커뮤니티센터(2층, 실내놀이방)","서울특별시 마포구 마포대로 195(아현동, 마포 래미안푸르지오 2단지 커뮤니티센터)",3146,1815,535,1234,7,11,2,3,0,8,3,1,0,6,1810,5,1331
1043,Mapo,투표소,AH,아현동제6투,"마포래미안푸르지오 4단지 커뮤니티센터(1층, 블록방)","서울특별시 마포구 마포대로 195(아현동, 마포 래미안 푸르지오 4단지 커뮤니티센터)",3694,2128,650,1417,8,14,2,4,0,8,3,0,1,8,2115,13,1566
1044,Mapo,투표소,DHW,도화동제1투,"도화동주민센터(4층, 강당)",서울특별시 마포구 도화길 37(도화동),2316,983,375,548,6,15,3,2,1,9,3,0,0,8,970,13,1333
1045,Mapo,투표소,DHW,도화동제2투,도화장난감대여점(1층),서울특별시 마포구 도화4길 53(도화동),2125,1141,321,776,6,13,1,2,0,11,0,0,2,3,1135,6,984
1046,Mapo,투표소,DHW,도화동제3투,"마포삼성아파트(1층, 관리사무소)","서울특별시 마포구 도화길 28(도화동, 삼성아파트)",1765,1085,259,782,3,13,2,2,0,7,1,0,0,8,1077,8,680
1047,Mapo,투표소,DHW,도화동제4투,"현대홈타운(1층, 경로당)","서울특별시 마포구 새창로8길 72(도화동, 현대홈타운)",1752,1046,377,623,7,10,1,2,0,7,5,0,0,6,1038,8,706
1048,Mapo,투표소,DHW,도화동제5투,"마포초등학교(1층, 음악실2)",서울특별시 마포구 도화2길 64(도화동),1784,815,315,455,1,13,3,7,0,1,4,1,0,4,804,11,969
1049,Mapo,투표소,DHW,도화동제6투,"우성아파트 9동(1층, 주차장)","서울특별시 마포구 삼개로 33(도화동, 도화3지구우성아파트)",2388,1513,384,1085,5,10,3,2,0,5,0,0,0,8,1502,11,875
1050,Mapo,투표소,DHW,도화동제7투,"마포쌍용황금아파트(1층, 경로당)","서울특별시 마포구 마포대로4라길 30(마포동, 마포쌍용황금아파트)",2125,1142,401,699,11,9,1,2,0,10,1,1,0,2,1137,5,983
1051,Mapo,투표소,YK,용강동제1투,"용강동주민센터(4층, 강당)",서울특별시 마포구 토정로31길 31(용강동),2811,1429,444,922,7,13,5,5,0,10,5,1,0,6,1418,11,1382
1052,Mapo,투표소,YK,용강동제2투,"용강동주민센터(지하1층, 다목적실)",서울특별시 마포구 토정로31길 31(용강동),2455,1157,350,751,2,17,2,4,0,12,2,0,1,11,1152,5,1298
1053,Mapo,투표소,YK,용강동제3투,"염리초등학교(1층, 다목적강당)",서울특별시 마포구 토정로37길 37(염리동),3262,1615,466,1088,6,19,0,8,1,9,3,0,0,5,1605,10,1647
1054,Mapo,투표소,YK,용강동제4투,"태영아파트(1층, 경로당)","서울특별시 마포구 독막로 266(대흥동, 대흥동태영아파트)",2245,1375,445,878,4,19,2,2,0,9,1,0,0,6,1366,9,870
1055,Mapo,투표소,YK,용강동제5투,"태영아파트(1층, 관리사무소)","서울특별시 마포구 독막로 266(대흥동, 대흥동태영아파트)",2432,1320,467,801,10,14,0,3,1,6,4,0,1,8,1315,5,1112
1056,Mapo,투표소,DH,대흥동제1투,"마포아트센터 문화동(지하1층, 다목적실)",서울특별시 마포구 대흥로20길 28(대흥동),2320,1100,395,662,8,9,5,2,0,6,2,3,0,2,1094,6,1220
1057,Mapo,투표소,DH,대흥동제2투,"양원주부학교(1층, 101호 교실)",서울특별시 마포구 고산18길 13(대흥동),1516,715,250,408,10,16,1,0,0,14,5,0,0,7,711,4,801
1058,Mapo,투표소,DH,대흥동제3투,"우리마포복지관(1층, 강당)",서울특별시 마포구 신촌로26길 10(노고산동),3365,1430,365,986,19,10,4,7,0,21,3,0,0,7,1422,8,1935
1059,Mapo,투표소,DH,대흥동제4투,"서울창천초등학교(1층, 정문 옆 필로티 하부)",서울특별시 마포구 백범로1길 56(노고산동),2853,1108,386,645,12,10,2,3,0,23,1,0,0,11,1093,15,1745
1060,Mapo,투표소,YR,염리동제1투,"서울디자인고등학교(1층, 구령대)",서울특별시 마포구 백범로 139(염리동),2031,758,258,467,8,7,0,2,0,8,0,0,0,4,754,4,1273
1061,Mapo,투표소,YR,염리동제2투,"서울한서초등학교(1층, 방과후1실)",서울특별시 마포구 대흥로24바길 27(염리동),1225,468,136,289,7,9,0,0,0,11,1,0,0,6,459,9,757
1062,Mapo,투표소,YR,염리동제3투,"마포아트센터(3층, 스튜디오3)",서울특별시 마포구 대흥로20길 28(대흥동),2748,1323,470,806,10,5,1,2,0,6,2,0,0,8,1310,13,1425
1063,Mapo,투표소,YR,염리동제4투,"서울여자중학교 정보관동(1층, 다목적실)",서울특별시 마포구 백범로25길 34(염리동),1672,880,281,554,5,10,0,1,1,4,2,1,0,9,868,12,792
1064,Mapo,투표소,SS,신수동제1투,"신수동주민센터(4층, 강당)",서울특별시 마포구 독막로 192(신수동),2815,1270,485,712,7,10,6,5,0,16,5,2,2,10,1260,10,1545
1065,Mapo,투표소,SS,신수동제2투,"신수중학교(1층, 다목적실)",서울특별시 마포구 신수로 49(신수동),1759,860,264,564,3,7,2,1,0,5,0,0,0,8,854,6,899
1066,Mapo,투표소,SS,신수동제3투,"광성중학교(1층, 체육예절실)",서울특별시 마포구 신수로8길 20(신수동),3634,1657,531,1047,8,20,6,1,0,12,2,0,1,12,1640,17,1977
1067,Mapo,투표소,SS,신수동제4투,"서울신석초등학교 슬기동(1층, 시청각실 앞 로비)",서울특별시 마포구 대흥로 33(신수동),3321,1628,540,1026,7,11,2,1,0,11,4,1,1,6,1610,18,1693
1068,Mapo,투표소,SS,신수동제5투,마포강변힐스테이트아파트(105동 4호라인 1층 다목적실),"서울특별시 마포구 신수로 15(현석동, 강변힐스테이트)",3017,1637,537,1026,7,23,2,4,1,9,2,0,1,15,1627,10,1380
1069,Mapo,투표소,SK,서강동제1투,"서강동주민센터(2층, 다목적실)",서울특별시 마포구 독막로 165(창전동),3278,1531,523,902,19,16,7,8,0,16,4,0,1,20,1516,15,1747
1070,Mapo,투표소,SK,서강동제2투,"창전동삼성아파트(1층, 경로당)","서울특별시 마포구 서강로 95(창전동, 창전동삼성아파트)",2733,1481,504,909,12,17,1,2,0,9,6,0,0,11,1471,10,1252
1071,Mapo,투표소,SK,서강동제3투,"창전동태영아파트(1층, 경로당)","서울특별시 마포구 서강로9길 45(창전동, 태영아파트)",3085,1535,557,874,18,22,6,8,0,12,4,0,1,17,1519,16,1550
1072,Mapo,투표소,SK,서강동제4투,"서강초등학교 서강나래관(2층, 체육관)",서울특별시 마포구 독막로 113(상수동),1898,795,261,480,9,6,3,2,0,10,2,0,1,11,785,10,1103
1073,Mapo,투표소,SK,서강동제5투,"두산위브아파트(1층, 주민회의실)","서울특별시 마포구 독막로18길 5(상수동, 상수두산위브아파트)",2734,1370,527,749,12,9,6,8,2,16,5,0,2,19,1355,15,1364
1074,Mapo,투표소,SK,서강동제6투,"마포어르신돌봄센터(지하1층, 다목적실)",서울특별시 마포구 토정로 148-14(상수동),3306,1846,474,1281,13,17,5,3,0,12,4,0,0,20,1829,17,1460
1075,Mapo,투표소,SKY,서교동제1투,"서교예술실험센터(1층, 전시실)",서울특별시 마포구 잔다리로6길 33(서교동),2983,1192,395,656,31,20,4,2,0,35,5,1,2,19,1170,22,1791
1076,Mapo,투표소,SKY,서교동제2투,"서교동주민센터(지하1층, 다목적실)",서울특별시 마포구 동교로15길 7(서교동),3518,1529,501,926,19,20,7,6,0,18,5,0,0,12,1514,15,1989
1077,Mapo,투표소,SKY,서교동제3투,"강원도민회관(지하1층, 대강당)",서울특별시 마포구 월드컵북로 25(서교동) 강원도민회관 대강당,2484,1060,423,565,11,11,4,4,1,8,6,0,0,16,1049,11,1424
1078,Mapo,투표소,SKY,서교동제4투,"서교동주민센터(4층, 강당)",서울특별시 마포구 동교로15길 7(서교동),3334,1305,577,632,14,17,5,3,0,15,11,0,1,20,1295,10,2029
1079,Mapo,투표소,SKY,서교동제5투,"재단법인홍합밸리(1층, 사무실 일부)",서울특별시 마포구 월드컵북로4길 77(동교동),1692,723,286,398,8,6,5,3,0,9,2,0,0,2,719,4,969
1080,Mapo,투표소,SKY,서교동제6투,"마포평생학습관(1층, 전시실)",서울특별시 마포구 홍익로2길 16(서교동),1783,811,256,492,7,11,3,5,0,16,4,0,0,9,803,8,972
1081,Mapo,투표소,SKY,서교동제7투,"농협하나로유통(10층, 대강당)",서울특별시 마포구 신촌로 66(노고산동),2671,1080,402,611,9,8,3,2,1,15,3,0,0,11,1065,15,1591
1082,Mapo,투표소,HJ,합정동제1투,우리마포시니어클럽(1층),서울특별시 마포구 동교로8길 58(합정동),2213,1002,397,521,10,17,5,2,0,13,7,1,1,13,987,15,1211
1083,Mapo,투표소,HJ,합정동제2투,"성산초등학교(1층, 다롱마루)",서울특별시 마포구 양화로3길 94(합정동),2325,944,381,502,6,10,4,2,0,10,1,0,0,14,930,14,1381
1084,Mapo,투표소,HJ,합정동제3투,"합정동주민센터(3층, 강당)",서울특별시 마포구 월드컵로5길 11(합정동),3225,1383,499,813,13,14,4,1,0,13,3,0,0,7,1367,16,1842
1085,Mapo,투표소,HJ,합정동제4투,"성산중학교(1층, 무용실)",서울특별시 마포구 성지1길 32-13(합정동),2177,1042,393,586,15,9,5,0,0,9,5,0,0,13,1035,7,1135
1086,Mapo,투표소,HJ,합정동제5투,"성산중학교(1층, 체육관)",서울특별시 마포구 성지1길 32-13(합정동),2421,1151,435,641,10,7,3,6,0,11,1,2,6,13,1135,16,1270
1087,Mapo,투표소,MW1,망원1동제1투,"망원1동주민센터(1층, 구 장난감대여점)",서울특별시 마포구 포은로6길 10(망원동),2639,1034,426,534,18,15,4,4,0,8,3,0,1,11,1024,10,1605
1088,Mapo,투표소,MW1,망원1동제2투,"삼우하이뷰아파트(1층, 주차장)","서울특별시 마포구 월드컵로11길 501층, 주차장(망원동, 삼우하이뷰아파트)",3119,1453,607,726,22,16,14,4,0,23,9,1,0,19,1441,12,1666
1089,Mapo,투표소,MW1,망원1동제3투,"망원1동주민센터(2층, 강당)",서울특별시 마포구 포은로6길 10(망원동),2749,1118,443,591,10,16,4,4,0,14,5,1,0,15,1103,15,1631
1090,Mapo,투표소,MW1,망원1동제4투,건설관리과 자재창고(1층),서울특별시 마포구 망원로 2(망원동),3326,1597,671,808,19,28,1,4,0,17,5,0,0,28,1581,16,1729
1091,Mapo,투표소,MW1,망원1동제5투,"망원나들목 체육관(1층, 체육관)",서울특별시 마포구 동교로1길 45(망원동),2519,1197,449,684,10,11,1,4,0,11,5,1,0,11,1187,10,1322
1092,Mapo,투표소,MW2,망원2동제1투,"망원2동 주민센터(지하1층, 강의실)",서울특별시 마포구 방울내로7길 11(망원동),2689,1254,518,649,8,18,5,1,0,14,4,3,2,15,1237,17,1435
1093,Mapo,투표소,MW2,망원2동제2투,"망원초등학교(1층, 음악실)",서울특별시 마포구 방울내로5길 28(망원동),2151,997,435,506,5,15,2,4,0,11,6,0,0,10,994,3,1154
1094,Mapo,투표소,MW2,망원2동제3투,"동교초등학교 신관(1층, 교무실 앞)",서울특별시 마포구 월드컵로25길 86(망원동),2829,1298,513,696,10,16,5,1,0,16,9,1,0,17,1284,14,1531
1095,Mapo,투표소,MW2,망원2동제4투,"동교초등학교 신관(1층, 행정실 앞)",서울특별시 마포구 월드컵로25길 86(망원동),2662,1259,549,643,12,14,4,4,0,14,4,0,1,6,1251,8,1403
1096,Mapo,투표소,MW2,망원2동제5투,"망원초등학교(1층, 과학실)",서울특별시 마포구 방울내로5길 28(망원동),2218,1075,465,535,20,13,3,2,1,12,1,0,0,13,1065,10,1143
1097,Mapo,투표소,YN,연남동제1투,"연남동주민센터(3층, 강당)",서울특별시 마포구 성미산로29길 17-9(연남동),2615,1023,397,548,14,19,1,2,0,11,6,0,0,13,1011,12,1592
1098,Mapo,투표소,YN,연남동제2투,"대명아파트(지하1층, 주차장)","서울특별시 마포구 동교로39길 11(연남동, 대명APT)",2255,942,349,518,17,16,1,4,0,10,2,0,2,9,928,14,1313
1099,Mapo,투표소,YN,연남동제3투,"경성고등학교(1층, 구내매점)",서울특별시 마포구 성미산로 111(연남동),3130,1353,509,756,10,22,7,3,0,14,3,2,1,15,1342,11,1777
1100,Mapo,투표소,YN,연남동제4투,"경성고등학교(1층, 체육관)",서울특별시 마포구 성미산로 111(연남동),3396,1508,601,827,18,20,3,2,0,15,3,0,0,12,1501,7,1888
1101,Mapo,투표소,SS1,성산1동제1투,"성산1동주민센터(1층, 강당)",서울특별시 마포구 성산로4길 15(성산동),2535,979,428,465,13,17,4,3,0,12,9,0,0,18,969,10,1556
1102,Mapo,투표소,SS1,성산1동제2투,"서울성서초등학교 정보관(1층, 소강당)",서울특별시 마포구 성미산로7길 24(성산동),2933,1369,653,618,22,13,2,0,2,18,6,0,0,28,1362,7,1564
1103,Mapo,투표소,SS1,성산1동제3투,성미산체육관(1층),서울특별시 마포구 월드컵북로15길 31-11(성산동),2200,849,340,446,16,13,2,0,0,8,1,0,1,11,838,11,1351
1104,Mapo,투표소,SS1,성산1동제4투,"서울중동초등학교(1층, 과학1실)",서울특별시 마포구 월드컵북로 152(성산동),2680,1103,438,612,6,11,1,3,0,14,1,0,1,12,1099,4,1577
1105,Mapo,투표소,SS1,성산1동제5투,"성서중학교(1층, 도서관)",서울특별시 마포구 성산로4길 42(성산동),2800,1187,507,595,11,15,7,1,0,9,9,2,0,21,1177,10,1613
1106,Mapo,투표소,SS2,성산2동제1투,"성산2동주민센터(지하1층, 탁구장)",서울특별시 마포구 월드컵북로30길 22(성산동),2701,1409,487,866,10,13,2,1,0,15,1,1,0,9,1405,4,1292
1107,Mapo,투표소,SS2,성산2동제2투,"성사중학교(1층, 보건교육실)",서울특별시 마포구 모래내로9길 16(성산동),3441,1643,686,860,11,20,2,4,0,24,4,0,0,11,1622,21,1798
1108,Mapo,투표소,SS2,성산2동제3투,"중동초등학교(1층, 도서관 앞 로비)",서울특별시 마포구 월드컵북로 152(성산동),3000,1147,467,617,14,18,2,3,0,11,1,0,1,5,1139,8,1853
1109,Mapo,투표소,SS2,성산2동제4투,"성원초등학교(1층, 표현활동실)",서울특별시 마포구 월드컵로36길 34(성산동),3023,1513,617,823,9,19,5,6,0,12,3,0,0,11,1505,8,1510
1110,Mapo,투표소,SS2,성산2동제5투,"마포구의회(1층, 다목적실)",서울특별시 마포구 월드컵로 212(성산동),3626,1472,620,697,32,13,4,7,0,51,10,0,1,17,1452,20,2154
1111,Mapo,투표소,SS2,성산2동제6투,"성산종합복지관(3층, 강당)",서울특별시 마포구 월드컵로 215(성산동),2777,1449,684,710,4,17,3,1,2,6,7,0,1,2,1437,12,1328
1112,Mapo,투표소,SS2,성산2동제7투,"신북초등학교(1층, 다목적실2)",서울특별시 마포구 월드컵북로38길 26(중동),2521,1354,578,712,8,15,2,3,0,12,6,0,0,6,1342,12,1167
1113,Mapo,투표소,SS2,성산2동제8투,"한국우진학교(1층, 연수실)",서울특별시 마포구 월드컵북로38길 21(중동),2965,1387,507,821,10,14,0,4,0,5,5,1,0,8,1375,12,1578
1114,Mapo,투표소,SS2,성산2동제9투,"중암중학교(2층, 체육관)",서울특별시 마포구 월드컵북로38길 25(중동),2757,1428,533,836,10,10,1,2,0,6,5,0,1,13,1417,11,1329
1115,Mapo,투표소,SA,상암동제1투,"상암동주민센터(4층, 다목적실)",서울특별시 마포구 매봉산로2길 16(상암동),3112,1280,453,742,11,12,0,4,0,26,4,0,0,10,1262,18,1832
1116,Mapo,투표소,SA,상암동제2투,"상암초등학교(2층, 연수실)",서울특별시 마포구 월드컵북로 353(상암동),2470,1205,470,684,7,9,0,2,0,10,3,0,1,7,1193,12,1265
1117,Mapo,투표소,SA,상암동제3투,"마포창업복지관(1층, 로비)",서울특별시 마포구 매봉산로 18(상암동),2070,1240,423,769,7,11,3,1,0,6,3,0,0,9,1232,8,830
1118,Mapo,투표소,SA,상암동제4투,"상암중학교(1층, 행복관로비)",서울특별시 마포구 상암산로1길 26(상암동),3010,1842,495,1288,10,8,8,3,0,8,2,1,0,6,1829,13,1168
1119,Mapo,투표소,SA,상암동제5투,"상지초등학교(1층, 로비)",서울특별시 마포구 월드컵로42길 30(상암동),2722,1515,634,832,12,10,2,1,0,12,1,1,0,5,1510,5,1207
1120,Mapo,투표소,SA,상암동제6투,"하늘초등학교(1층, 중앙로비)",서울특별시 마포구 월드컵북로 502-14(상암동),2886,1492,748,666,14,15,4,4,0,20,9,0,0,2,1482,10,1394
1121,Mapo,투표소,SA,상암동제7투,"하늘초등학교 (1층, 우측로비)",서울특별시 마포구 월드컵북로 502-14(상암동),3320,1824,796,936,15,25,2,4,0,15,3,1,0,9,1806,18,1496
1122,Yangcheon,투표소,M1,목1동제1투,"목1동주민센터(2층, 휴게실)",서울특별시 양천구 목동서로 192(목동),3007,1561,426,1083,9,13,1,0,0,10,1,0,0,8,1551,10,1446
1123,Yangcheon,투표소,M1,목1동제2투,"목운초등학교(1층, 보건교육실)",서울특별시 양천구 목동동로 235(목동),3028,1702,486,1170,4,14,0,4,0,14,1,0,0,2,1695,7,1326
1124,Yangcheon,투표소,M1,목1동제3투,"목동삼익아파트(1층, 경로당)",서울특별시 양천구 목동동로12길 45(목동),3439,1858,668,1112,11,23,3,3,0,15,1,2,0,4,1842,16,1581
1125,Yangcheon,투표소,M1,목1동제4투,"7단지목동아파트 관리사무소(1층, 에어로빅실)",서울특별시 양천구 목동로 212(목동),2772,1645,514,1063,8,17,5,4,0,16,4,0,0,3,1634,11,1127
1126,Yangcheon,투표소,M1,목1동제5투,"서정초등학교(1층, 상담회의실)",서울특별시 양천구 목동로8길 19(목동),3194,1711,488,1176,5,10,3,2,0,9,0,2,1,9,1705,6,1483
1127,Yangcheon,투표소,M1,목1동제6투,"목동청소년센터(1층, 체육관)",서울특별시 양천구 목동서로 143(목동),2888,1537,330,1178,5,7,3,1,1,4,1,1,0,1,1532,5,1351
1128,Yangcheon,투표소,M2,목2동제1투,"목2동주민센터(4층, 다목적실)",서울특별시 양천구 목동중앙본로 120(목동),2705,1073,436,577,7,18,0,0,0,18,4,2,1,4,1067,6,1632
1129,Yangcheon,투표소,M2,목2동제2투,"목동종합사회복지관(5층, 강당)",서울특별시 양천구 목동중앙북로8길 104(목동),2821,1282,454,784,4,5,2,2,0,10,4,0,1,7,1273,9,1539
1130,Yangcheon,투표소,M2,목2동제3투,"목동문화체육센터(1층, 다목적실)",서울특별시 양천구 목동중앙본로 73(목동),2935,1345,499,767,7,17,0,7,0,22,5,1,0,9,1334,11,1590
1131,Yangcheon,투표소,M2,목2동제4투,새말어르신사랑방(1층),서울특별시 양천구 목동중앙본로2길 13-11(목동),2719,1337,465,828,5,13,2,1,0,8,3,1,2,4,1332,5,1382
1132,Yangcheon,투표소,M2,목2동제5투,"양화초등학교(1층, 예향실)",서울특별시 양천구 목동중앙북로16길 57(목동),2057,983,358,559,3,15,3,5,0,14,1,0,2,6,966,17,1074
1133,Yangcheon,투표소,M2,목2동제6투,"한국전파진흥협회(2층, 로비)",서울특별시 양천구 목동중앙로13나길 3(목동),2022,943,372,533,3,10,2,1,0,5,3,2,1,5,937,6,1079
1134,Yangcheon,투표소,M2,목2동제7투,"목동문화체육센터(2층, 체육관)",서울특별시 양천구 목동중앙본로 73(목동),2592,1248,533,666,5,15,3,7,0,2,3,1,0,4,1239,9,1344
1135,Yangcheon,투표소,M2,목2동제8투,"양화초등학교(3층, 체육관)",서울특별시 양천구 목동중앙북로16길 57(목동),2441,1062,410,592,9,13,3,2,0,13,5,0,2,7,1056,6,1379
1136,Yangcheon,투표소,M3,목3동제1투,"양동중학교(1층, 3-1반)",서울특별시 양천구 목동중앙북로 49(목동),2583,1369,355,976,2,10,1,4,0,6,0,2,2,7,1365,4,1214
1137,Yangcheon,투표소,M3,목3동제2투,"양동중학교(1층, 3-3반)",서울특별시 양천구 목동중앙북로 49(목동),3377,1239,507,671,9,17,3,5,0,10,3,1,0,6,1232,7,2138
1138,Yangcheon,투표소,M3,목3동제3투,"목3동주민센터(3층, 다목적실)",서울특별시 양천구 목동중앙남로16나길 55(목동),2957,1147,416,667,8,19,2,1,0,11,8,0,0,3,1135,12,1810
1139,Yangcheon,투표소,M3,목3동제4투,"목3동주민센터(3층, 음악실)",서울특별시 양천구 목동중앙남로16나길 55(목동),3105,1276,513,686,9,20,2,5,0,13,4,4,0,12,1268,8,1829
1140,Yangcheon,투표소,M3,목3동제5투,"목3동주민센터(2층, 꿈자람도서관)",서울특별시 양천구 목동중앙남로16나길 55(목동),2806,1091,456,589,7,10,1,2,1,11,3,0,0,2,1082,9,1715
1141,Yangcheon,투표소,M4,목4동제1투,"목4동주민센터(3층, 다목적홀)",서울특별시 양천구 목동중앙로 25(목동),2605,1171,407,715,9,10,2,2,0,14,1,0,0,5,1165,6,1434
1142,Yangcheon,투표소,M4,목4동제2투,"영도중학교(1층, 1-4반)",서울특별시 양천구 목동중앙남로 27(목동),2497,932,316,575,10,8,1,2,0,10,1,0,0,5,928,4,1565
1143,Yangcheon,투표소,M4,목4동제3투,"영도중학교(1층, 1-5반)",서울특별시 양천구 목동중앙남로 27(목동),3142,1443,549,825,8,20,2,2,0,14,3,0,0,7,1430,13,1699
1144,Yangcheon,투표소,M4,목4동제4투,"목동실버복지문화센터(2층, 다목적실)",서울특별시 양천구 목동중앙로3길 21(목동),2679,1131,452,632,2,15,2,3,1,4,3,1,0,4,1119,12,1548
1145,Yangcheon,투표소,M4,목4동제5투,"강서고등학교(1층, 챔버홀)",서울특별시 양천구 목동중앙남로 27(목동),2762,1278,487,733,9,19,1,1,0,13,2,0,1,2,1268,10,1484
1146,Yangcheon,투표소,M4,목4동제6투,"정목초등학교(2층, 해오름관)",서울특별시 양천구 목동중앙로3길 30-10(목동),3137,1539,616,856,10,13,5,4,0,10,5,0,0,8,1527,12,1598
1147,Yangcheon,투표소,M5,목5동제1투,"목5동주민센터(6층, 목마홀)",서울특별시 양천구 목동서로 41(목동),2412,1283,324,916,5,10,3,1,0,11,1,0,0,4,1275,8,1129
1148,Yangcheon,투표소,M5,목5동제2투,"영도초등학교(1층, 다목적실)",서울특별시 양천구 목동중앙로 70(목동),2910,1771,469,1263,8,11,2,4,0,4,2,0,0,5,1768,3,1139
1149,Yangcheon,투표소,M5,목5동제3투,"사회적경제지원센터(1층, 희망카페)",서울특별시 양천구 목동동로 375(목동),2780,1475,321,1112,5,14,1,5,0,5,0,0,0,4,1467,8,1305
1150,Yangcheon,투표소,M5,목5동제4투,"목동아파트5단지(1층, 경로당)",서울특별시 양천구 목동동로 350(목동),2437,1601,341,1235,3,6,0,2,0,6,0,0,0,2,1595,6,836
1151,Yangcheon,투표소,M5,목5동제5투,"월촌중학교(1층, 가정교육과정실)",서울특별시 양천구 목동서로 31(목동),2800,1434,370,1034,7,4,1,2,0,3,2,1,0,5,1429,5,1366
1152,Yangcheon,투표소,M5,목5동제6투,"월촌초등학교(1층, 1-6반)",서울특별시 양천구 목동중앙로 132(목동),2059,1271,303,941,3,6,1,2,0,4,0,0,1,4,1265,6,788
1153,Yangcheon,투표소,M5,목5동제7투,"신목중학교(1층, 3-1반)",서울특별시 양천구 목동중앙로 88(목동),2546,1548,345,1173,6,6,1,1,0,8,1,0,0,4,1545,3,998
1154,Yangcheon,투표소,M5,목5동제8투,"경인초등학교(1층, 2-1반)",서울특별시 양천구 안양천로 1009(목동),2331,1398,345,1016,3,7,4,3,0,9,2,1,2,3,1395,3,933
1155,Yangcheon,투표소,M5,목5동제9투,"목원초등학교(1층, 2-1반)",서울특별시 양천구 목동중앙로 204(목동),2876,1729,567,1106,8,10,3,3,0,6,2,1,0,7,1713,16,1147
1156,Yangcheon,투표소,SW1,신월1동제1투,"신월1동주민센터(1층, 민원실)",서울특별시 양천구 곰달래로1길 38(신월동),3461,1358,566,736,9,14,1,3,0,11,2,1,1,8,1352,6,2103
1157,Yangcheon,투표소,SW1,신월1동제2투,"서울특별시서부여성발전센터(3층, 강당)",서울특별시 양천구 남부순환로 371(신월동),2943,1102,466,589,5,14,0,1,0,7,5,0,1,3,1091,11,1841
1158,Yangcheon,투표소,SW1,신월1동제3투,"돌다리 주민모임 사무실(1층, 스위트드림 주상복합)",서울특별시 양천구 곰달래로11길 56(신월동),2424,1036,434,569,1,9,0,2,0,10,0,1,0,3,1029,7,1388
1159,Yangcheon,투표소,SW1,신월1동제4투,곰달래꿈마을 주민공동이용시설(1층),서울특별시 양천구 곰달래로 36(신월동),2953,1201,456,689,4,19,2,3,0,8,5,0,1,3,1190,11,1752
1160,Yangcheon,투표소,SW1,신월1동제5투,"동서유리(1층, 창고)",서울특별시 양천구 곰달래로6길 39(신월동),3549,1622,702,876,8,15,1,3,0,6,2,0,0,2,1615,7,1927
1161,Yangcheon,투표소,SW2,신월2동제1투,"신월2동주민센터(3층, 다목적홀)",서울특별시 양천구 중앙로53길 47(신월동),2567,1104,455,615,4,10,1,1,0,6,4,0,0,3,1099,5,1463
1162,Yangcheon,투표소,SW2,신월2동제2투,"신강초등학교 (1층, 교사연수실)",서울특별시 양천구 중앙로55길 72(신월동),1687,775,293,462,4,7,0,3,0,1,1,0,0,1,772,3,912
1163,Yangcheon,투표소,SW2,신월2동제3투,"신월종합사회복지관(지하1층, 강당)",서울특별시 양천구 신월로24길 19(신월동),3736,1978,748,1147,5,28,4,11,0,13,4,0,1,7,1968,10,1758
1164,Yangcheon,투표소,SW2,신월2동제4투,"양강초등학교 (1층, 보건교육실)",서울특별시 양천구 오목로 101(신월동),3126,1306,537,718,4,11,3,4,0,5,3,0,0,7,1292,14,1820
1165,Yangcheon,투표소,SW2,신월2동제5투,"양강중학교(2층, 해가람관 음악실)",서울특별시 양천구 중앙로 319(신월동),2815,1082,426,604,8,11,0,3,0,17,1,1,0,6,1077,5,1733
1166,Yangcheon,투표소,SW3,신월3동제1투,"신월3동주민센터(3층, 다목적홀)",서울특별시 양천구 남부순환로54길 5(신월동),2617,859,374,460,4,8,0,2,0,1,3,1,0,2,855,4,1758
1167,Yangcheon,투표소,SW3,신월3동제2투,"신원초등학교(1층, 후관 과학실)",서울특별시 양천구 남부순환로58길 32(신월동),2766,967,404,524,5,9,2,0,0,4,3,1,0,1,953,14,1799
1168,Yangcheon,투표소,SW3,신월3동제3투,"신월청소년문화센터(2층, 꿈터)",서울특별시 양천구 가로공원로 86(신월동),2375,884,349,493,8,13,0,1,0,6,1,1,2,3,877,7,1491
1169,Yangcheon,투표소,SW3,신월3동제4투,"서울금융고등학교(1층, 보건교육실)",서울특별시 양천구 가로공원로61길 19(신월동),2955,1018,414,560,10,12,1,2,0,6,2,0,0,5,1012,6,1937
1170,Yangcheon,투표소,SW4,신월4동제1투,"신월4동주민센터(지하1층, 대강당)",서울특별시 양천구 오목로5길 34(신월동),3352,1513,619,837,7,22,0,1,0,9,5,0,0,4,1504,9,1839
1171,Yangcheon,투표소,SW4,신월4동제2투,"강서초등학교(1층, 다목적교육실)",서울특별시 양천구 오목로 31(신월동),2837,1296,551,699,5,14,1,4,0,10,5,0,0,1,1290,6,1541
1172,Yangcheon,투표소,SW4,신월4동제3투,"한빛종합사회복지관(3층, 강당)",서울특별시 양천구 신월로11길 16(신월동),3245,1508,657,790,7,20,1,4,0,12,1,1,2,2,1497,11,1737
1173,Yangcheon,투표소,SW4,신월4동제4투,"강서초등학교(1층, 목련관 로비)",서울특별시 양천구 오목로 31(신월동),2382,985,468,478,5,18,0,2,0,8,1,0,1,1,982,3,1397
1174,Yangcheon,투표소,SW5,신월5동제1투,"신월중학교(2층, 달마루관 체육관)",서울특별시 양천구 남부순환로29길 25(신월동),3188,1304,539,715,12,11,1,2,1,12,1,0,1,5,1300,4,1884
1175,Yangcheon,투표소,SW5,신월5동제2투,"신월5동주민센터(4층, 다목적홀)",서울특별시 양천구 화곡로4길 10(신월동),3203,1272,532,701,3,8,1,4,0,7,2,2,2,2,1264,8,1931
1176,Yangcheon,투표소,SW5,신월5동제3투,"신화중학교(1층, 자기주도학습실)",서울특별시 양천구 남부순환로29길 35(신월동),3366,1222,491,671,7,19,3,4,0,8,4,2,0,6,1215,7,2144
1177,Yangcheon,투표소,SW6,신월6동제1투,"신월6동주민센터 임시청사(5층, 디엔케이빌딩 501호 강당)",서울특별시 양천구 남부순환로 609(신월동),2020,985,344,602,6,13,1,1,0,4,1,0,1,2,975,10,1035
1178,Yangcheon,투표소,SW6,신월6동제2투,"신남초등학교(1층, 꿈나무교실4)",서울특별시 양천구 남부순환로83길 44(신월동),2656,1362,472,861,5,12,0,3,2,2,0,0,2,1,1360,2,1294
1179,Yangcheon,투표소,SW6,신월6동제3투,"강신중학교(1층, 생물실)",서울특별시 양천구 남부순환로 604(신월동),1386,678,302,355,5,4,0,1,1,3,0,0,0,2,673,5,708
1180,Yangcheon,투표소,SW6,신월6동제4투,"목동센트럴아이파크위브 401동(1층, 시니어라운지)","서울특별시 양천구 남부순환로83길 47(신월동, 목동 센트럴 아이파크 위브 4단지)",2426,1297,454,795,7,14,1,1,0,8,3,1,0,4,1288,9,1129
1181,Yangcheon,투표소,SW7,신월7동제1투,"신월7동주민센터(3층, 해맞이홀)",서울특별시 양천구 남부순환로70길 16-3(신월동),2555,967,386,543,5,15,0,1,0,3,2,0,1,1,957,10,1588
1182,Yangcheon,투표소,SW7,신월7동제2투,지양어르신사랑방(1층),서울특별시 양천구 지양로17길 15지양어르신사랑방(신월동),2483,1069,439,579,2,17,1,3,0,7,3,1,0,3,1055,14,1414
1183,Yangcheon,투표소,SW7,신월7동제3투,"양천중학교(1층, 야구부실내연습실)",서울특별시 양천구 지양로7길 32(신월동),2181,940,389,530,1,6,1,1,1,2,1,0,1,2,935,5,1241
1184,Yangcheon,투표소,SW7,신월7동제4투,"신월문화체육센터(1층, 로비)",서울특별시 양천구 지양로 47(신월동),2045,906,353,511,10,12,1,1,1,4,1,0,1,1,896,10,1139
1185,Yangcheon,투표소,SW7,신월7동제5투,"신월시영아파트(1층, 어르신사랑방)",서울특별시 양천구 신월로 99(신월동),2680,1417,618,752,3,15,1,7,0,5,3,0,2,3,1409,8,1263
1186,Yangcheon,투표소,SW7,신월7동제6투,"강월초등학교(1층, 영어교실2)",서울특별시 양천구 신월로 97(신월동),2445,1205,440,724,3,17,0,4,0,5,3,1,1,1,1199,6,1240
1187,Yangcheon,투표소,SJ1,신정1동제1투,"신정1동주민센터(3층, 대강당)",서울특별시 양천구 중앙로32길 1(신정동),2806,1245,437,761,5,11,4,3,0,10,1,0,0,10,1242,3,1561
1188,Yangcheon,투표소,SJ1,신정1동제2투,"신서초등학교(1층, 6-7반)",서울특별시 양천구 목동서로10길 35 (신정동),2739,1454,453,948,9,10,0,5,0,10,2,0,1,7,1445,9,1285
1189,Yangcheon,투표소,SJ1,신정1동제3투,"신서초등학교 (1층,무용실)",서울특별시 양천구 목동서로10길 35 (신정동),2227,1381,305,1048,3,7,2,2,0,6,0,0,0,4,1377,4,846
1190,Yangcheon,투표소,SJ1,신정1동제4투,"목동아파트10단지 관리사무소(1층, 할아버지방)",서울특별시 양천구 목동서로 400(신정동),2162,1395,348,1005,8,4,0,2,0,9,3,0,2,7,1388,7,767
1191,Yangcheon,투표소,SJ1,신정1동제5투,"서울신서중학교(1층, 다목적교과실)",서울특별시 양천구 중앙로 206(신정동),1842,1000,266,701,11,3,2,2,0,5,3,0,0,0,993,7,842
1192,Yangcheon,투표소,SJ2,신정2동제1투,"목동중학교(1층, 3-15반)",서울특별시 양천구 목동동로 172(신정동),3197,1533,547,923,10,13,0,5,0,14,4,0,1,4,1521,12,1664
1193,Yangcheon,투표소,SJ2,신정2동제2투,"신목초등학교(1층, 체육관 영어교실)",서울특별시 양천구 신목로5길 11-6(신정동),2718,1419,533,848,9,3,1,3,0,6,2,0,0,5,1410,9,1299
1194,Yangcheon,투표소,SJ2,신정2동제3투,"목동초등학교(2층, 영어교실)",서울특별시 양천구 목동동로12길 12(신정동),3161,1607,562,980,7,11,2,5,2,14,5,0,3,4,1595,12,1554
1195,Yangcheon,투표소,SJ2,신정2동제4투,"목동중학교(1층, 제1음악실)",서울특별시 양천구 목동동로 172(신정동),2684,1378,467,848,11,15,3,2,0,7,3,0,0,8,1364,14,1306
1196,Yangcheon,투표소,SJ3,신정3동제1투,"신정3동주민센터(3층, 대강당)",서울특별시 양천구 중앙로 209(신정동),3022,1267,468,749,5,16,2,3,0,9,0,1,0,3,1256,11,1755
1197,Yangcheon,투표소,SJ3,신정3동제2투,"남명초등학교(1층, 구 급식실)",서울특별시 양천구 중앙로23길 3(신정동),2292,866,328,511,3,9,0,2,0,3,4,0,0,3,863,3,1426
1198,Yangcheon,투표소,SJ3,신정3동제3투,"래미안 목동아델리체 110동(1층, 시니어클럽)",서울특별시 양천구 중앙로43길 14(신정동),1948,1089,460,589,2,14,1,2,0,7,5,2,1,0,1083,6,859
1199,Yangcheon,투표소,SJ3,신정3동제4투,"신남중학교(1층, 동아리실)",서울특별시 양천구 중앙로29길 109(신월동),3645,1565,628,878,4,21,4,2,1,9,4,0,0,4,1555,10,2080
1200,Yangcheon,투표소,SJ3,신정3동제5투,"신기초등학교(1층, 정랑채체육관)",서울특별시 양천구 신정로 292(신정동),3134,1654,577,1015,14,15,1,3,0,9,6,0,1,5,1646,8,1480
1201,Yangcheon,투표소,SJ3,신정3동제6투,"학마을2단지 관리사무소(2층, 마을도서관)","서울특별시 양천구 신정로14길 1(신정동, 학마을아파트)",2679,1370,596,739,4,11,1,1,0,3,3,0,0,4,1362,8,1309
1202,Yangcheon,투표소,SJ3,신정3동제7투,"신정3동 넓은들민원센터(2층, 강당)",서울특별시 양천구 남부순환로88길 5-7(신정동),2674,1335,518,769,8,12,1,4,0,7,4,1,0,4,1328,7,1339
1203,Yangcheon,투표소,SJ3,신정3동제8투,"지향초등학교 별관(1층, 무용실)",서울특별시 양천구 신정로11길 74(신정동),2805,1440,568,821,10,20,1,2,0,5,2,0,1,3,1433,7,1365
1204,Yangcheon,투표소,SJ3,신정3동제9투,"지향초등학교 별관(1층, 돌봄교실)",서울특별시 양천구 신정로11길 74(신정동),2988,1622,735,830,7,25,2,4,1,6,4,0,1,3,1618,4,1366
1205,Yangcheon,투표소,SJ3,신정3동제10투,"이펜하우스3단지 314동(1층, 도서방)","서울특별시 양천구 신정이펜1로 50(신정동, 신정이펜하우스3단지)",2852,1578,759,746,4,25,4,2,1,12,3,0,0,4,1560,18,1274
1206,Yangcheon,투표소,SJ3,신정3동제11투,"이펜하우스2단지 204동(1층, 경로당 앞 회의실)","서울특별시 양천구 신정이펜2로 55(신정동, 신정 이펜하우스 2단지)",2035,1196,546,601,8,14,3,3,0,10,2,1,1,4,1193,3,839
1207,Yangcheon,투표소,SJ3,신정3동제12투,"대일관광고등학교(1층, 1-3반)",서울특별시 양천구 신정이펜1로 11(신정동),1972,1103,525,535,6,10,1,2,0,8,2,0,2,4,1095,8,869
1208,Yangcheon,투표소,SJ4,신정4동제1투,"신서고등학교(1층, 샘누리관)",서울특별시 양천구 은행정로 42(신정동),3417,1483,674,733,9,21,1,0,0,15,6,1,1,11,1472,11,1934
1209,Yangcheon,투표소,SJ4,신정4동제2투,"신정4동주민센터(5층, 은행정홀)",서울특별시 양천구 오목로34길 5(신정동),2515,1007,369,576,6,22,0,4,0,9,4,1,0,3,994,13,1508
1210,Yangcheon,투표소,SJ4,신정4동제3투,"신정4동주민센터(지하1층, 주차장)",서울특별시 양천구 오목로34길 5(신정동),2692,990,384,542,4,17,2,4,0,12,3,1,0,5,974,16,1702
1211,Yangcheon,투표소,SJ4,신정4동제4투,"양목초등학교(1층, 보건교육실)",서울특별시 양천구 목동로11길 30(신정동),2799,1304,519,732,7,13,0,2,0,9,2,2,0,6,1292,12,1495
1212,Yangcheon,투표소,SJ4,신정4동제5투,개울도서관&건강센터(1층),서울특별시 양천구 중앙로52길 56(신정동),3132,1533,632,836,8,16,5,4,0,13,4,0,0,3,1521,12,1599
1213,Yangcheon,투표소,SJ4,신정4동제6투,"신정종합사회복지관(지하1층, 강당)",서울특별시 양천구 신정중앙로 36(신정동),3231,1466,691,718,4,11,4,2,0,13,6,1,1,3,1454,12,1765
1214,Yangcheon,투표소,SJ4,신정4동제7투,"서울양동초등학교(2층, 해마루관 식당 로비)",서울특별시 양천구 오목로23길 24(신정동),2785,1143,495,594,7,12,0,3,0,12,3,0,2,7,1135,8,1642
1215,Yangcheon,투표소,SJ4,신정4동제8투,"신정종합사회복지관(2층, 참여실)",서울특별시 양천구 신정중앙로 36(신정동),3304,1404,557,787,4,24,3,4,0,6,4,0,3,3,1395,9,1900
1216,Yangcheon,투표소,SJ6,신정6동제1투,"신정6동주민센터(1층, 민원실)",서울특별시 양천구 목동서로 353(신정동),2216,1265,293,931,3,7,1,3,1,7,1,1,0,5,1253,12,951
1217,Yangcheon,투표소,SJ6,신정6동제2투,"양천문화회관 별관(1층, 전시실)",서울특별시 양천구 목동서로 367(신정동),1857,1087,275,784,4,5,1,1,0,5,3,0,0,0,1078,9,770
1218,Yangcheon,투표소,SJ6,신정6동제3투,"목동아파트14단지 관리사무소(1층, 할머니사랑방)",서울특별시 양천구 목동동로 130(신정동),2991,1911,450,1408,6,15,0,3,0,8,4,0,0,6,1900,11,1080
1219,Yangcheon,투표소,SJ6,신정6동제4투,"서울목일중학교(1층, 도서실)",서울특별시 양천구 목동동로8길 70(신정동),2966,1787,561,1180,4,8,1,2,0,12,2,1,1,8,1780,7,1179
1220,Yangcheon,투표소,SJ6,신정6동제5투,"목동아파트8단지 관리사무소(1층, 어르신사랑방)",서울특별시 양천구 목동서로 280(신정동),2642,1622,531,1052,5,6,1,4,0,6,2,1,0,8,1616,6,1020
1221,Yangcheon,투표소,SJ6,신정6동제6투,"양천해누리복지관(지하2층, 구 양천장애인복지관 강당)",서울특별시 양천구 목동동로 159(신정동),1904,1041,313,699,5,8,1,0,0,3,1,0,0,5,1035,6,863
1222,Yangcheon,투표소,SJ7,신정7동제1투,"신정7동주민센터(2층, 대강의실)",서울특별시 양천구 목동동로 37(신정동),2276,1110,286,778,6,14,1,1,0,14,2,0,0,4,1106,4,1166
1223,Yangcheon,투표소,SJ7,신정7동제2투,신오새마을금고(3층),서울특별시 양천구 목동남로4길 26(신정동 175-6),2600,1515,529,925,11,15,6,1,1,6,3,1,1,4,1503,12,1085
1224,Yangcheon,투표소,SJ7,신정7동제3투,"목동2차우성아파트 103동 앞 관리사무실(1층, 경로당)","서울특별시 양천구 목동남로4길 6-46(신정동, 목동2차우성아파트)",3145,1545,567,913,7,25,2,3,1,8,3,1,1,5,1536,9,1600
1225,Yangcheon,투표소,SJ7,신정7동제4투,"계남초등학교(1층, 교사연수실)",서울특별시 양천구 목동동로2길 54(신정동 325-7),2547,1365,420,909,3,10,4,1,0,8,3,1,0,0,1359,6,1182
1226,Yangcheon,투표소,SJ7,신정7동제5투,"양천지역복지발전센터(1층, 양천아파트 내)",서울특별시 양천구 목동로3길 57(신정동 276),2269,1198,480,666,6,21,1,1,1,1,1,3,2,4,1187,11,1071
1227,Yangcheon,투표소,SJ7,신정7동제6투,"양천아파트 관리사무소(1층, 할머니방)",서울특별시 양천구 목동로3길 57(신정동 276),2335,1231,475,711,2,21,0,2,0,9,1,1,0,0,1222,9,1104
1228,Yangcheon,투표소,SJ7,신정7동제7투,"목동12단지아파트 관리복지관(1층, 할머니방)",서울특별시 양천구 목동동로 50(신정동 326),2444,1525,457,1017,7,17,0,3,0,6,3,1,0,6,1517,8,919
1229,Yangcheon,투표소,SJ7,신정7동제8투,"갈산도서관(지하1층, 주차장)",서울특별시 양천구 목동남로4길 48-6(신정동 337-9),1850,1144,387,714,4,4,1,4,0,10,3,1,1,3,1132,12,706
1230,Gangseo,투표소,YCH,염창동제1투,"기아대책(1층, 로비)",서울특별시 강서구 공항대로59다길 109(염창동),3601,1756,624,1045,14,26,1,3,0,18,7,0,0,8,1746,10,1845
1231,Gangseo,투표소,YCH,염창동제2투,"강서구평생학습관(2층, 강당)",서울특별시 강서구 공항대로 615(염창동),3341,1828,605,1144,13,16,2,4,0,14,6,1,1,12,1818,10,1513
1232,Gangseo,투표소,YCH,염창동제3투,"염동초등학교(1층, 1-1반)",서울특별시 강서구 양천로73길 17(염창동),3369,1641,654,917,14,12,2,4,0,14,6,0,1,10,1634,7,1728
1233,Gangseo,투표소,YCH,염창동제4투,"염창중학교(1층, 가사실)",서울특별시 강서구 양천로67가길 83(염창동),2731,1374,567,750,9,16,3,4,0,6,3,1,3,2,1364,10,1357
1234,Gangseo,투표소,YCH,염창동제5투,"염창동주민센터(3층, 다목적실)",서울특별시 강서구 양천로67가길 63(염창동),2566,1204,487,666,5,18,5,4,0,12,1,0,0,2,1200,4,1362
1235,Gangseo,투표소,YCH,염창동제6투,"우림블루나인 비즈니스센터 B동(1층, 로비)",서울특별시 강서구 양천로 583(염창동),3680,1934,715,1119,8,20,1,6,0,20,9,0,0,17,1915,19,1746
1236,Gangseo,투표소,YCH,염창동제7투,"동아그린프라자 (1층, 로비)",서울특별시 강서구 양천로 731(염창동),2609,1519,561,898,4,14,0,3,0,13,3,0,1,8,1505,14,1090
1237,Gangseo,투표소,YCH,염창동제8투,"염창초등학교 서관(1층, 우리반)",서울특별시 강서구 양천로 646-28(염창동),3487,1876,724,1062,11,13,0,6,0,24,6,0,0,14,1860,16,1611
1238,Gangseo,투표소,DCH1,등촌제1동제1투,"SBA국제유통센터 A동(1층, 로비)",서울특별시 강서구 공항대로61길 29(등촌동),3820,1773,678,1003,12,18,3,3,0,20,6,0,0,12,1755,18,2047
1239,Gangseo,투표소,DCH1,등촌제1동제2투,"서울시니어스가양타워(1층, 홀론카페)",서울특별시 강서구 화곡로68길 102(등촌동),3974,1746,545,1119,4,23,1,1,1,12,8,1,2,6,1723,23,2228
1240,Gangseo,투표소,DCH1,등촌제1동제3투,"등촌1동주민센터(3층, 다목적실)",서울특별시 강서구 공항대로53가길 55(등촌동),4999,1861,728,998,19,30,4,9,0,30,10,0,1,10,1839,22,3138
1241,Gangseo,투표소,DCH1,등촌제1동제4투,"백석초등학교(1층, 체육관)",서울특별시 강서구 공항대로 491(등촌동),3685,1390,541,757,15,21,3,7,0,14,7,0,1,13,1379,11,2295
1242,Gangseo,투표소,DCH2,등촌제2동제1투,"시립강서도서관(1층, 문화교실)",서울특별시 강서구 등촌로51나길 29(등촌동),3156,1289,510,707,9,14,6,5,1,12,4,1,2,8,1279,10,1867
1243,Gangseo,투표소,DCH2,등촌제2동제2투,"강서구의회(1층, 로비)",서울특별시 강서구 등촌로 185(등촌동),3951,1575,606,890,4,17,2,5,0,21,8,1,1,4,1559,16,2376
1244,Gangseo,투표소,DCH2,등촌제2동제3투,"등마초등학교(1층, 체육관)",서울특별시 강서구 등촌로35길 12(등촌동),3316,1363,539,780,4,6,2,1,0,11,5,0,1,6,1355,8,1953
1245,Gangseo,투표소,DCH2,등촌제2동제4투,"등촌동아이파크아파트 109동 (지하1층, 문화센터)",서울특별시 강서구 등촌로 163(등촌동),3263,1920,529,1332,5,20,2,4,0,7,4,0,0,3,1906,14,1343
1246,Gangseo,투표소,DCH3,등촌제3동제1투,"등촌1종합사회복지관(1층, 프로그램실)",서울특별시 강서구 강서로68길 36(등촌동),2859,1342,547,739,5,14,1,3,0,6,7,1,1,4,1328,14,1517
1247,Gangseo,투표소,DCH3,등촌제3동제2투,"등양초등학교(1층, 보건교육실)",서울특별시 강서구 강서로56나길 140(등촌동),3121,1780,629,1084,13,10,2,5,0,16,6,0,2,5,1772,8,1341
1248,Gangseo,투표소,DCH3,등촌제3동제3투,"등현초등학교(1층, 강당)",서울특별시 강서구 화곡로65길 124(등촌동),3187,1645,587,1004,8,14,2,1,0,12,4,0,0,3,1635,10,1542
1249,Gangseo,투표소,DCH3,등촌제3동제4투,"등촌9종합사회복지관(3층, 강당)",서울특별시 강서구 화곡로63가길 92(등촌동),2069,972,371,560,5,15,2,0,0,5,0,0,0,1,959,13,1097
1250,Gangseo,투표소,DCH3,등촌제3동제5투,"등촌7종합사회복지관(3층, 강당)",서울특별시 강서구 공항대로43길 104(등촌동),2004,946,372,537,4,11,0,2,0,4,2,0,1,3,936,10,1058
1251,Gangseo,투표소,DCH3,등촌제3동제6투,"등촌3동주민센터(3층, 다목적실)",서울특별시 강서구 화곡로63길 96(등촌동),2532,1068,421,607,6,14,0,2,0,5,3,1,1,3,1063,5,1464
1252,Gangseo,투표소,DCH3,등촌제3동제7투,"미주진로아파트 관리사무소(1층, 경로당)",서울특별시 강서구 공항대로 351-21(등촌동),2481,1301,529,729,4,16,2,2,0,5,2,1,1,5,1296,5,1180
1253,Gangseo,투표소,DCH3,등촌제3동제8투,"등촌4종합사회복지관(1층, 복지관로비)",서울특별시 강서구 공항대로39길 59(등촌동),2115,1052,437,569,4,15,1,2,0,4,2,0,1,4,1039,13,1063
1254,Gangseo,투표소,DCH3,등촌제3동제9투,"주공3단지아파트 관리동(1층, 주민공동실)",서울특별시 강서구 강서로56나길 37(등촌동),1833,1088,369,670,3,13,1,5,0,8,3,1,0,4,1077,11,745
1255,Gangseo,투표소,HKB,화곡본동제1투,"화곡본동주민센터(지층, 체육실)",서울특별시 강서구 초록마을로5길 29(화곡동),3908,1416,660,689,10,17,2,1,1,7,7,0,0,7,1401,15,2492
1256,Gangseo,투표소,HKB,화곡본동제2투,"화곡초등학교(1층, 제2과학실)",서울특별시 강서구 초록마을로 28(화곡동),4426,1306,565,639,16,20,6,4,0,24,10,1,1,5,1291,15,3120
1257,Gangseo,투표소,HKB,화곡본동제3투,"화곡초등학교(1층, 제1과학실)",서울특별시 강서구 초록마을로 28(화곡동),4174,1615,671,851,14,18,4,5,0,9,13,0,1,9,1595,20,2559
1258,Gangseo,투표소,HKB,화곡본동제4투,"화곡새마을금고 본점(4층, 대강당)",서울특별시 강서구 화곡로 192(화곡동),3766,1489,609,783,11,17,1,10,0,21,12,0,0,6,1470,19,2277
1259,Gangseo,투표소,HKB,화곡본동제5투,"화일초등학교(2층, 도서실)",서울특별시 강서구 까치산로10길 70(화곡동),3901,1341,594,674,10,29,2,2,0,9,1,0,0,6,1327,14,2560
1260,Gangseo,투표소,HKB,화곡본동제6투,"화일초등학교(1층, 정문 로비)",서울특별시 강서구 까치산로10길 70(화곡동),4064,1577,706,796,20,22,3,6,1,8,3,1,2,6,1574,3,2487
1261,Gangseo,투표소,HK1,화곡제1동제1투,"화곡1동주민센터(2층, 다목적실)",서울특별시 강서구 곰달래로 79(화곡동),4851,1468,592,790,6,23,1,7,0,21,7,0,1,6,1454,14,3383
1262,Gangseo,투표소,HK1,화곡제1동제2투,"예촌경로당(2층, 다목적실)",서울특별시 강서구 곰달래로 83-1(화곡동),4493,1435,607,717,17,16,4,11,0,26,9,4,1,14,1426,9,3058
1263,Gangseo,투표소,HK1,화곡제1동제3투,"화곡1동주민센터(3층, 작은도서관)",서울특별시 강서구 곰달래로 79(화곡동),4906,1537,632,811,11,23,4,3,0,21,5,0,1,6,1517,20,3369
1264,Gangseo,투표소,HK1,화곡제1동제4투,"화곡새마을금고 화곡1동지점(지하1층, 다목적실)",서울특별시 강서구 강서로17길 118(화곡동),3988,1420,542,793,11,28,4,6,0,11,4,0,0,6,1405,15,2568
1265,Gangseo,투표소,HK1,화곡제1동제5투,"화곡노인복지센터(4층, 강당)",서울특별시 강서구 월정로30길 96(화곡동),2963,1237,535,661,3,20,0,3,0,8,0,0,0,3,1233,4,1726
1266,Gangseo,투표소,HK1,화곡제1동제6투,"월정초등학교 신관(1층, 실내체육실)",서울특별시 강서구 월정로 176(화곡동),3228,1020,422,530,13,10,2,6,0,18,6,0,0,3,1010,10,2208
1267,Gangseo,투표소,HK1,화곡제1동제7투,"월정초등학교 신관(1층, 상담실)",서울특별시 강서구 월정로 176(화곡동),3306,1328,620,652,5,19,5,4,0,7,4,2,0,6,1324,4,1978
1268,Gangseo,투표소,HK1,화곡제1동제8투,"공원노인정(1층, 경로당)",서울특별시 강서구 가로공원로77길 30(화곡동),3456,1420,553,778,14,24,2,7,0,14,7,0,0,4,1403,17,2036
1269,Gangseo,투표소,HK1,화곡제1동제9투,"신월초등학교 꿈자람터(2층, 체육관)",서울특별시 강서구 강서로31길 48(화곡동),3504,1395,569,763,9,18,1,3,0,10,5,0,0,5,1383,12,2109
1270,Gangseo,투표소,HK1,화곡제1동제10투,"신월초등학교 꿈자람터(2층, 체육관)",서울특별시 강서구 강서로31길 48(화곡동),3832,1490,647,771,15,17,3,4,0,13,2,1,0,7,1480,10,2342
1271,Gangseo,투표소,HK2,화곡제2동제1투,"화곡2동주민센터(2층, 도서관)",서울특별시 강서구 곰달래로37길 13(화곡동),2123,843,339,470,3,17,2,1,0,2,0,1,0,1,836,7,1280
1272,Gangseo,투표소,HK2,화곡제2동제2투,"화곡2동주민센터(3층, 다목적실)",서울특별시 강서구 곰달래로37길 13(화곡동),2851,1120,476,595,10,15,0,7,0,4,2,1,0,3,1113,7,1731
1273,Gangseo,투표소,HK2,화곡제2동제3투,"신정초등학교(1층, 돌봄교실6)",서울특별시 강서구 곰달래로31가길 27(화곡동),3595,1273,562,649,9,14,1,8,0,11,5,2,0,4,1265,8,2322
1274,Gangseo,투표소,HK2,화곡제2동제4투,"신정초등학교(1층, 1-1반)",서울특별시 강서구 곰달래로31가길 27(화곡동),3820,1249,540,635,10,16,2,4,0,17,3,1,0,5,1233,16,2571
1275,Gangseo,투표소,HK3,화곡제3동제1투,"화곡3동주민센터(3층, 다목적홀)",서울특별시 강서구 강서로33가길 17(화곡동),2901,1147,443,647,5,11,3,4,0,13,5,1,1,7,1140,7,1754
1276,Gangseo,투표소,HK3,화곡제3동제2투,"화곡3동주민센터(지하1층, 공연장)",서울특별시 강서구 강서로33가길 17(화곡동),3072,1143,447,627,6,21,1,5,0,13,9,0,0,5,1134,9,1929
1277,Gangseo,투표소,HK3,화곡제3동제3투,"화곡초록아파트(2층, 관리사무소회의실)",서울특별시 강서구 강서로45다길 30-27(화곡동),2937,1544,602,887,7,23,1,3,0,5,4,0,1,5,1538,6,1393
1278,Gangseo,투표소,HK3,화곡제3동제4투,"화곡푸르지오아파트 관리동(1층, 입주자대표회의실)",서울특별시 강서구 화곡로13길 107(화곡동),3045,2028,502,1461,9,15,3,4,0,11,1,2,0,5,2013,15,1017
1279,Gangseo,투표소,HK3,화곡제3동제5투,"화곡푸르지오아파트(1층, 멀티미디어사랑방)",서울특별시 강서구 화곡로13길 107(화곡동),3027,1602,554,1001,9,8,2,2,0,13,0,0,0,6,1595,7,1425
1280,Gangseo,투표소,HK4,화곡제4동제1투,"시립화곡청소년센터(1층, 로비)",서울특별시 강서구 곰달래로57가길 26(화곡동),2843,1091,420,628,1,16,1,5,0,6,3,0,0,5,1085,6,1752
1281,Gangseo,투표소,HK4,화곡제4동제2투,"화곡4동주민센터(3층, 다목적실)",서울특별시 강서구 곰달래로57가길 26(화곡동),2892,1026,379,616,2,14,1,2,0,4,0,0,0,5,1023,3,1866
1282,Gangseo,투표소,HK4,화곡제4동제3투,"한광고등학교 별관(1층, 방송댄스반)",서울특별시 강서구 등촌로13바길 8-22(화곡동),3310,1060,412,600,4,14,4,3,0,7,5,0,1,2,1052,8,2250
1283,Gangseo,투표소,HK4,화곡제4동제4투,"신정여자중학교(1층, 도서관)",서울특별시 강서구 등촌로13아길 20(화곡동),2526,921,332,540,6,14,2,1,0,5,6,1,0,5,912,9,1605
1284,Gangseo,투표소,HK4,화곡제4동제5투,"신곡초등학교 본관(1층, 로비)",서울특별시 강서구 등촌로13자길 42-14(화곡동),3068,1260,529,677,12,16,0,3,0,9,3,2,0,4,1255,5,1808
1285,Gangseo,투표소,HK6,화곡제6동제1투,"화곡6동주민센터(2층, 도서실)",서울특별시 강서구 화곡로 312(화곡동),4596,1574,618,865,9,20,4,4,0,21,10,0,0,12,1563,11,3022
1286,Gangseo,투표소,HK6,화곡제6동제2투,"교남학교(1층, 강당)",서울특별시 강서구 까치산로22길 38(화곡동),2940,1276,504,695,4,21,1,1,1,10,4,2,0,7,1250,26,1664
1287,Gangseo,투표소,HK6,화곡제6동제3투,"등서초등학교(1층, 과학실)",서울특별시 강서구 화곡로58길 86(화곡동),2920,1309,504,751,7,13,2,3,0,10,3,0,0,5,1298,11,1611
1288,Gangseo,투표소,HK6,화곡제6동제4투,"강서구시설관리공단(3층, 회의실)",서울특별시 강서구 우장산로 114(화곡동),4761,1913,695,1117,15,35,4,6,0,13,4,1,0,12,1902,11,2848
1289,Gangseo,투표소,HK6,화곡제6동제5투,"우장산롯데캐슬아파트 관리사무소(1층, 요가실)",서울특별시 강서구 공항대로 382(화곡동),2608,1731,448,1234,7,10,1,3,0,9,4,1,1,3,1721,10,877
1290,Gangseo,투표소,HK8,화곡제8동제1투,"화곡8동주민센터(3층, 다목적실)",서울특별시 강서구 곰달래로25길 45(화곡동),3834,1369,586,718,5,10,0,5,0,18,8,0,0,5,1355,14,2465
1291,Gangseo,투표소,HK8,화곡제8동제2투,"곰달래문화복지센터(1층, 로비)",서울특별시 강서구 강서로5길 50(화곡동),3222,1240,547,622,6,25,0,2,0,7,5,2,1,10,1227,13,1982
1292,Gangseo,투표소,HK8,화곡제8동제3투,"화곡8동 주민센터(2층, 도서실)",서울특별시 강서구 곰달래로25길 45(화곡동),3737,1423,620,719,10,27,2,3,1,16,6,0,0,6,1410,13,2314
1293,Gangseo,투표소,HK8,화곡제8동제4투,"목양건물(1층, 주차장)",서울특별시 강서구 초록마을로 144(화곡동),3157,1234,592,575,9,20,1,2,0,14,6,0,0,5,1224,10,1923
1294,Gangseo,투표소,HK8,화곡제8동제5투,현대태권도체육관(2층),서울특별시 강서구 강서로18다길 17(화곡동),3534,1424,643,714,5,19,3,5,0,7,3,0,0,9,1408,16,2110
1295,Gangseo,투표소,WJS,우장산동제1투,"우장산동주민센터(3층, 다목적실)",서울특별시 강서구 우현로 34(화곡동),3590,1545,607,877,12,15,4,2,0,11,6,1,0,4,1539,6,2045
1296,Gangseo,투표소,WJS,우장산동제2투,"강서문화원(1층, 갤러리 서)",서울특별시 강서구 화곡로 215(화곡동),2805,1192,480,661,4,15,1,3,0,13,7,1,0,1,1186,6,1613
1297,Gangseo,투표소,WJS,우장산동제3투,"강서새마을지회(1층, 회의실)",서울특별시 강서구 화곡로31가길 34(화곡동),2699,1197,397,745,11,13,0,4,1,9,4,0,0,7,1191,6,1502
1298,Gangseo,투표소,WJS,우장산동제4투,"아이파크이편한세상 관리동(2층, 회의실)",서울특별시 강서구 강서로 266(화곡동),2875,1523,529,951,11,6,1,3,0,7,1,0,0,4,1513,10,1352
1299,Gangseo,투표소,WJS,우장산동제5투,"내발산초등학교(1층, 보건교육실)",서울특별시 강서구 강서로46길 23(내발산동),3892,1791,720,989,16,21,2,2,1,11,6,3,2,2,1775,16,2101
1300,Gangseo,투표소,WJS,우장산동제6투,"내발산문화센터(지하1층, 다목적실)",서울특별시 강서구 강서로52길 89(내발산동),3747,2026,647,1311,7,23,0,2,1,10,0,0,1,8,2010,16,1721
1301,Gangseo,투표소,WJS,우장산동제7투,"강서구민회관(1층, 로비)",서울특별시 강서구 우장산로 66(내발산동),3502,1785,695,1029,2,20,4,5,1,10,5,0,0,7,1778,7,1717
1302,Gangseo,투표소,WJS,우장산동제8투,"강서힐스테이트아파트 관리동(1층, 회의실)",서울특별시 강서구 우현로 67(화곡동),3595,2030,602,1352,9,26,2,3,0,18,3,0,0,3,2018,12,1565
1303,Gangseo,투표소,KY1,가양제1동제1투,"양천초등학교 체육관(1층, 로비)",서울특별시 강서구 양천로 329(가양동),3111,1503,542,903,8,13,3,2,0,15,2,0,0,7,1495,8,1608
1304,Gangseo,투표소,KY1,가양제1동제2투,"서남물재생센터(1층, 휴게실)",서울특별시 강서구 양천로 201(마곡동),1752,840,311,490,2,17,0,5,0,6,0,0,1,1,833,7,912
1305,Gangseo,투표소,KY1,가양제1동제3투,"가양1동주민센터(3층, 다목적실)",서울특별시 강서구 허준로 30(가양동),2436,1198,351,812,5,5,2,4,0,7,4,0,0,3,1193,5,1238
1306,Gangseo,투표소,KY1,가양제1동제4투,"동양고등학교 본관(1층, 세미나실)",서울특별시 강서구 허준로 50(가양동),2030,873,300,527,2,17,0,0,0,10,4,1,0,8,869,4,1157
1307,Gangseo,투표소,KY1,가양제1동제5투,"성재중학교 (1층, 보건실앞 로비)",서울특별시 강서구 허준로 36(가양동),1721,900,284,582,5,7,0,1,0,8,3,0,0,5,895,5,821
1308,Gangseo,투표소,KY1,가양제1동제6투,강서한강자이아파트 관리사무소내 멀티홀 (지하1층),서울특별시 강서구 양천로55길 55(가양동),2186,1318,428,839,4,11,4,2,0,9,3,1,1,6,1308,10,868
1309,Gangseo,투표소,KY1,가양제1동제7투,"마곡엠밸리4단지아파트 관리사무소내 (1층, 주민공동시설)",서울특별시 강서구 마곡서로 175(마곡동),4106,1624,665,855,9,20,4,8,0,31,9,0,0,2,1603,21,2482
1310,Gangseo,투표소,KY1,가양제1동제8투,"서울식물원 보타닉홀(2층, 좌측)",서울특별시 강서구 마곡동로 161(마곡동),3748,1083,391,591,16,11,3,6,0,31,7,1,1,7,1065,18,2665
1311,Gangseo,투표소,KY1,가양제1동제9투,"서울식물원 보타닉홀(2층, 우측)",서울특별시 강서구 마곡동로 161(마곡동),3333,919,345,504,9,6,2,3,0,31,3,0,0,6,909,10,2414
1312,Gangseo,투표소,KY2,가양제2동제1투,"가양2동주민센터(3층, 다목적실)",서울특별시 강서구 허준로 93(가양동),1827,987,234,730,2,6,2,1,0,5,0,0,1,1,982,5,840
1313,Gangseo,투표소,KY2,가양제2동제2투,강변어르신사랑방(1층),서울특별시 강서구 허준로 139(가양동),2165,1138,430,664,6,9,1,3,0,6,2,0,0,8,1129,9,1027
1314,Gangseo,투표소,KY2,가양제2동제3투,"가양4종합사회복지관(지하1층, 강당)",서울특별시 강서구 양천로57길 37(가양동),2347,1022,412,564,1,15,3,1,0,4,4,1,2,9,1016,6,1325
1315,Gangseo,투표소,KY2,가양제2동제4투,"가양5종합사회복지관(1층, 어르신사랑방)",서울특별시 강서구 양천로57길 36(가양동),1788,880,333,509,4,10,0,1,1,1,3,0,0,3,865,15,908
1316,Gangseo,투표소,KY2,가양제2동제5투,"탐라영재관(1층, 로비)",서울특별시 강서구 양천로57길 10-10(가양동),2610,1418,536,817,9,17,1,0,1,14,3,1,2,7,1408,10,1192
1317,Gangseo,투표소,KY3,가양제3동제1투,"가양8단지아파트(1층, 경로당)",서울특별시 강서구 허준로 176(가양동),2316,1114,415,647,4,11,2,3,0,11,10,0,0,4,1107,7,1202
1318,Gangseo,투표소,KY3,가양제3동제2투,"가양3동주민센터(3층, 다목적실)",서울특별시 강서구 허준로 202(가양동),2440,1014,350,629,3,13,3,0,0,3,2,0,0,5,1008,6,1426
1319,Gangseo,투표소,KY3,가양제3동제3투,"가양9-2단지아파트(1층, 경로당)",서울특별시 강서구 허준로 234(가양동),2161,1101,460,595,4,16,3,0,0,6,1,1,0,4,1090,11,1060
1320,Gangseo,투표소,KY3,가양제3동제4투,"가양7종합사회복지관(1층, 로비)",서울특별시 강서구 허준로 209(가양동),1718,808,305,464,2,15,0,0,1,7,4,0,0,3,801,7,910
1321,Gangseo,투표소,KY3,가양제3동제5투,"가양6단지아파트(1층, 경로당)",서울특별시 강서구 허준로 175(가양동),2116,1155,430,678,8,17,1,3,0,10,2,1,0,2,1152,3,961
1322,Gangseo,투표소,BS1,발산제1동제1투,"발산초등학교(1층, 과학실2)",서울특별시 강서구 강서로45길 113(내발산동),2778,1193,537,595,3,16,3,4,0,14,3,0,0,8,1183,10,1585
1323,Gangseo,투표소,BS1,발산제1동제2투,"발산1동주민센터(3층, 다목적실)",서울특별시 강서구 강서로47길 54(내발산동),2417,933,405,483,5,16,0,4,0,7,1,1,0,5,927,6,1484
1324,Gangseo,투표소,BS1,발산제1동제3투,"화곡고등학교 홍신관(2층, 목련실)",서울특별시 강서구 강서로45길 69(내발산동),3060,1335,500,754,14,21,1,3,0,12,3,2,1,5,1316,19,1725
1325,Gangseo,투표소,BS1,발산제1동제4투,"마곡수명산파크1단지아파트 (1층, 주민공동시설)",서울특별시 강서구 강서로47길 108(내발산동),3332,1841,752,1015,14,22,3,3,0,15,1,0,0,7,1832,9,1491
1326,Gangseo,투표소,BS1,발산제1동제5투,"수명중학교(2층, 체육관)",서울특별시 강서구 수명로2길 16(내발산동),3536,1656,662,938,12,15,1,1,0,8,5,1,0,2,1645,11,1880
1327,Gangseo,투표소,BS1,발산제1동제6투,"수명초등학교(1층, 2-1반)",서울특별시 강서구 수명로1길 84(내발산동),3437,1707,728,907,10,16,4,5,0,15,3,0,0,4,1692,15,1730
1328,Gangseo,투표소,BS1,발산제1동제7투,"마곡엠밸리14단지 관리동(1층, 경로당)",서울특별시 강서구 마곡중앙로 33(마곡동),2578,1454,708,704,2,14,0,4,0,8,3,0,1,2,1446,8,1124
1329,Gangseo,투표소,BS1,발산제1동제8투,"마곡엠밸리15단지 관리동(1층, 경로당)",서울특별시 강서구 마곡중앙로 36(마곡동),2266,1289,580,657,9,16,1,5,0,9,4,0,2,2,1285,4,977
1330,Gangseo,투표소,KH,공항동제1투,"공항중학교(1층, 도서실 로비)",서울특별시 강서구 방화대로 241(공항동),3374,1563,597,915,5,14,2,5,0,10,3,1,0,3,1555,8,1811
1331,Gangseo,투표소,KH,공항동제2투,"송정초등학교(1층, 솔밭누리터 로비)",서울특별시 강서구 공항대로3길 18(공항동),3437,1206,395,738,11,18,2,5,0,17,2,1,1,3,1193,13,2231
1332,Gangseo,투표소,KH,공항동제3투,"공항동주민센터(2층, 다목적실)",서울특별시 강서구 송정로 45(공항동),2657,936,356,532,4,17,0,2,0,7,4,0,0,4,926,10,1721
1333,Gangseo,투표소,KH,공항동제4투,"송정중학교 (1층, 식당)",서울특별시 강서구 남부순환로 121(공항동),2778,907,349,514,2,11,1,2,0,8,4,0,0,3,894,13,1871
1334,Gangseo,투표소,KH,공항동제5투,"송정중학교(1층, 로비)",서울특별시 강서구 남부순환로 121(공항동),2567,1045,401,611,5,11,0,4,0,6,2,0,0,1,1041,4,1522
1335,Gangseo,투표소,KH,공항동제6투,"공진초등학교(1층, 로비)",서울특별시 강서구 마곡서로 33(마곡동),4427,2262,1040,1163,8,16,0,10,0,9,4,0,0,2,2252,10,2165
1336,Gangseo,투표소,BH1,방화제1동제1투,"한서고등학교 지산관(1층, 가사실)",서울특별시 강서구 양천로11길 47(방화동),2450,1227,502,686,8,11,2,2,0,4,2,0,1,4,1222,5,1223
1337,Gangseo,투표소,BH1,방화제1동제2투,"방신시장 고객지원센터(지하1층, 다목적실)",서울특별시 강서구 방화동로 124-1(방화동),2663,1234,396,783,4,21,2,2,0,4,5,0,0,5,1222,12,1429
1338,Gangseo,투표소,BH1,방화제1동제3투,"방화구립경로당(1층, 어르신사랑방)",서울특별시 강서구 방화대로37길 47-5(방화동),2684,1081,392,636,8,19,0,2,0,4,2,0,0,6,1069,12,1603
1339,Gangseo,투표소,BH1,방화제1동제4투,"송화초등학교 (1층, 2-1반)",서울특별시 강서구 방화대로34길 2(방화동),2340,884,283,564,5,15,1,3,0,2,0,1,1,4,879,5,1456
1340,Gangseo,투표소,BH1,방화제1동제5투,"항공비즈니스고등학교(1층, 무한나래도서관)",서울특별시 강서구 방화대로34길 13(마곡동),2483,1148,437,680,3,8,0,1,0,6,1,0,0,3,1139,9,1335
1341,Gangseo,투표소,BH1,방화제1동제6투,"공항고등학교 후문(1층, 로비)",서울특별시 강서구 방화대로34길 43(마곡동),3186,1519,520,941,8,17,1,4,0,12,3,0,2,5,1513,6,1667
1342,Gangseo,투표소,BH1,방화제1동제7투,"방화1동주민센터(4층, 다목적실)",서울특별시 강서구 방화대로 330(마곡동),2495,1147,450,642,7,14,2,1,0,9,6,1,0,3,1135,12,1348
1343,Gangseo,투표소,BH1,방화제1동제8투,"마곡중학교(1층, 로비)",서울특별시 강서구 마곡중앙5로 58(마곡동),2922,1466,597,805,10,17,1,2,0,18,2,0,0,5,1457,9,1456
1344,Gangseo,투표소,BH1,방화제1동제9투,"마곡엠밸리6단지(1층, 경로당)",서울특별시 강서구 마곡서1로 100(마곡동),2733,1488,679,763,4,19,2,3,0,3,2,1,1,4,1481,7,1245
1345,Gangseo,투표소,BH1,방화제1동제10투,"공항초등학교(1층, 로비)",서울특별시 강서구 마곡서1로 68(마곡동),3933,2203,822,1303,14,20,1,6,0,14,5,0,2,6,2193,10,1730
1346,Gangseo,투표소,BH2,방화제2동제1투,"방화중학교(1층, 교직원식당)",서울특별시 강서구 개화동로27길 9(방화동),3084,1155,436,661,5,25,4,2,0,8,2,0,0,0,1143,12,1929
1347,Gangseo,투표소,BH2,방화제2동제2투,"방화2동주민센터(2층, 도서관)",서울특별시 강서구 개화동로23길 20(방화동),2641,1007,362,595,5,19,0,3,0,2,6,0,2,3,997,10,1634
1348,Gangseo,투표소,BH2,방화제2동제3투,"방화초등학교(1층, 1-4반)",서울특별시 강서구 양천로6길 92(방화동),2989,1349,531,773,2,10,3,7,0,5,2,2,0,8,1343,6,1640
1349,Gangseo,투표소,BH2,방화제2동제4투,"신마곡벽산블루밍 청년복합문화공간(2층, 북카페)",서울특별시 강서구 양천로10길 38(방화동),2834,1402,486,847,5,22,1,5,2,10,9,1,0,3,1391,11,1432
1350,Gangseo,투표소,BH2,방화제2동제5투,"방화11종합사회복지관(지하1층, 강당)",서울특별시 강서구 개화동로21길 4(방화동),2049,1010,409,565,1,16,0,1,0,2,0,0,1,4,999,11,1039
1351,Gangseo,투표소,BH2,방화제2동제6투,"내촌어르신사랑방(1층, 경로당)",서울특별시 강서구 개화동로13길 12-8(개화동),1308,660,159,482,2,5,0,0,1,3,0,0,0,1,653,7,648
1352,Gangseo,투표소,BH2,방화제2동제7투,"방화초등학교(1층, 1-3반)",서울특별시 강서구 양천로6길 92(방화동),1975,849,326,488,4,12,1,2,0,5,0,1,0,3,842,7,1126
1353,Gangseo,투표소,BH3,방화제3동제1투,"방화3동주민센터(3층, 다목적실)",서울특별시 강서구 금낭화로24길 5(방화동),3009,1270,502,726,4,13,0,0,0,8,3,0,0,3,1259,11,1739
1354,Gangseo,투표소,BH3,방화제3동제2투,"정곡초등학교(1층, 체육관)",서울특별시 강서구 방화대로50길 22(방화동),1927,923,399,494,1,11,2,0,0,4,3,0,0,2,916,7,1004
1355,Gangseo,투표소,BH3,방화제3동제3투,"방화2종합사회복지관(2층, 강당)",서울특별시 강서구 방화대로48길 40(방화동),1859,924,400,494,2,9,0,1,0,1,2,1,0,2,912,12,935
1356,Gangseo,투표소,BH3,방화제3동제4투,"치현초등학교(1층, 해맑은반)",서울특별시 강서구 방화대로47길 43(방화동),2743,1304,404,859,10,7,1,5,0,7,0,0,0,7,1300,4,1439
1357,Gangseo,투표소,BH3,방화제3동제5투,"국립국어원(1층, 로비)",서울특별시 강서구 금낭화로 154(방화동),1995,1170,354,773,8,9,0,4,0,7,3,0,0,5,1163,7,825
1358,Gangseo,투표소,BH3,방화제3동제6투,"방화6종합사회복지관(1층, 경로당)",서울특별시 강서구 금낭화로23길 25(방화동),1835,938,334,562,8,14,1,2,0,5,2,0,0,3,931,7,897
1359,Gangseo,투표소,BH3,방화제3동제7투,"방원중학교(1층, 보건교육실)",서울특별시 강서구 금낭화로 268(방화동),2341,1071,350,680,4,13,0,3,0,3,3,0,0,2,1058,13,1270
1360,Guro,투표소,SDR,신도림동제1투,"신도림동주민센터(3층, 강당)",서울특별시 구로구 신도림로 40(신도림동),2774,1217,446,734,3,8,0,4,0,6,2,0,0,2,1205,12,1557
1361,Guro,투표소,SDR,신도림동제2투,대림2차아파트 경로당(1층),"서울특별시 구로구 신도림로 16(신도림동, 신도림대림1,2차아파트)",2578,1686,592,1025,15,20,2,4,0,8,2,0,0,7,1675,11,892
1362,Guro,투표소,SDR,신도림동제3투,"신미림초등학교(1층, 1-3반)",서울특별시 구로구 신도림로 26(신도림동),2311,1368,515,804,8,12,1,2,1,4,4,1,1,3,1356,12,943
1363,Guro,투표소,SDR,신도림동제4투,"신미림초등학교(1층, 1-1반)",서울특별시 구로구 신도림로 26(신도림동),2623,1301,471,781,5,16,0,4,0,8,0,0,0,6,1291,10,1322
1364,Guro,투표소,SDR,신도림동제5투,"신도림초등학교(1층, 영어실)",서울특별시 구로구 신도림로19길 44(신도림동),2968,1705,678,971,7,15,1,4,0,9,3,0,0,8,1696,9,1263
1365,Guro,투표소,SDR,신도림동제6투,"신도림중학교(1층, 다목적교과전용실)",서울특별시 구로구 경인로63길 74(신도림동),2775,1601,582,963,10,14,0,3,0,7,3,2,2,5,1591,10,1174
1366,Guro,투표소,SDR,신도림동제7투,"신도림중학교(창조관1층, 과학실1)",서울특별시 구로구 경인로63길 74(신도림동),3413,1739,571,1103,7,14,3,2,0,15,2,0,2,7,1726,13,1674
1367,Guro,투표소,SDR,신도림동제8투,대림4차아파트 경로당(1층),"서울특별시 구로구 경인로65길 16-15(신도림동, 신도림4차e편한세상)",2880,1779,528,1207,4,6,1,5,0,7,1,1,2,3,1765,14,1101
1368,Guro,투표소,KR1,구로제1동제1투,"구일초등학교(1층, 영어실)",서울특별시 구로구 구일로 68(구로동),2493,1188,463,704,2,3,0,1,0,4,1,1,0,1,1180,8,1305
1369,Guro,투표소,KR1,구로제1동제2투,구로주공아파트 경로당(1층),"서울특별시 구로구 구일로4길 65(구로동, 구로주공아파트)",2182,1117,403,660,6,16,1,2,1,6,7,0,0,6,1108,9,1065
1370,Guro,투표소,KR1,구로제1동제3투,"구일초등학교(1층, 시청각실)",서울특별시 구로구 구일로 68(구로동),2164,1174,439,682,5,16,5,2,0,7,3,1,1,4,1165,9,990
1371,Guro,투표소,KR1,구로제1동제4투,"구일고등학교(1층, 무용실)",서울특별시 구로구 구일로 90-51(구로동),2334,1136,432,657,4,16,1,1,1,8,4,0,0,5,1129,7,1198
1372,Guro,투표소,KR1,구로제1동제5투,"구일중학교(1층, 새솔관 도서실)",서울특별시 구로구 구일로 90-133(구로동),3127,1358,564,728,13,20,0,2,0,12,1,0,0,6,1346,12,1769
1373,Guro,투표소,KR2,구로제2동제1투,"구로제2동주민센터(3층, 프로그램실)",서울특별시 구로구 구로동로 141(구로동),2389,779,364,397,1,6,1,1,0,2,3,0,0,0,775,4,1610
1374,Guro,투표소,KR2,구로제2동제2투,"시립구로청소년센터(2층, 북카페)",서울특별시 구로구 구로동로 141(구로동),1797,604,258,327,1,5,0,0,0,5,2,0,1,1,600,4,1193
1375,Guro,투표소,KR2,구로제2동제3투,"시립구로청소년센터(1층, 실습실)",서울특별시 구로구 구로동로 141(구로동),2044,697,294,379,1,11,0,1,0,3,0,1,0,1,691,6,1347
1376,Guro,투표소,KR2,구로제2동제4투,구로2동 경로당(1층),서울특별시 구로구 구로동로28길 25-13(구로동),2583,914,386,487,4,14,1,3,0,5,2,2,0,4,908,6,1669
1377,Guro,투표소,KR2,구로제2동제5투,"구로초등학교(1층, 체육관 우측)",서울특별시 구로구 구로중앙로27나길 9(구로동),2069,805,379,395,6,6,0,2,1,3,1,1,0,3,797,8,1264
1378,Guro,투표소,KR2,구로제2동제6투,"화원종합사회복지관(1층, 로비 정문)",서울특별시 구로구 벚꽃로 484(구로동),3463,1697,692,952,11,13,0,2,0,11,2,1,1,2,1687,10,1766
1379,Guro,투표소,KR2,구로제2동제7투,"화원종합사회복지관(1층, 로비 후문)",서울특별시 구로구 벚꽃로 484(구로동),1939,618,243,358,6,8,0,0,0,0,1,0,0,0,616,2,1321
1380,Guro,투표소,KR2,구로제2동제8투,"구로초등학교(1층, 체육관 좌측)",서울특별시 구로구 구로중앙로27나길 9(구로동),2382,1008,393,569,5,9,3,3,0,4,5,0,1,5,997,11,1374
1381,Guro,투표소,KR2,구로제2동제9투,"서울구로기계공구상업단지조합(5층, 대회의실)",서울특별시 구로구 구로중앙로 198(구로동),916,357,148,189,1,10,0,0,0,3,2,0,0,2,355,2,559
1382,Guro,투표소,KR3,구로제3동제1투,"구로제3동주민센터(3층, 1강의실)",서울특별시 구로구 디지털로31길 109(구로동),1921,716,363,331,1,6,1,1,0,1,1,0,1,0,706,10,1205
1383,Guro,투표소,KR3,구로제3동제2투,"구로3동 경로당(1층, 꿈마을도서관)",서울특별시 구로구 디지털로27다길 65(구로동),2118,798,401,359,4,9,1,1,0,6,4,1,0,4,790,8,1320
1384,Guro,투표소,KR3,구로제3동제3투,"영서중학교(1층, 보건교육실)",서울특별시 구로구 도림로20길 35(구로동),2468,1207,559,609,6,9,0,0,0,3,5,1,0,5,1197,10,1261
1385,Guro,투표소,KR3,구로제3동제4투,"영서초등학교(1층, 신체활동실)",서울특별시 구로구 도림로20길 57(구로동),2608,1144,556,549,6,15,1,4,0,5,1,0,1,3,1141,3,1464
1386,Guro,투표소,KR3,구로제3동제5투,신성미소지움아파트 경로당(1층),"서울특별시 구로구 시흥대로161길 50(구로동, 신성미소지움)",2176,834,382,393,5,17,0,7,0,8,3,0,0,5,820,14,1342
1387,Guro,투표소,KR3,구로제3동제6투,삼성래미안아파트 경로당(1층),"서울특별시 구로구 디지털로31길 90(구로동, 삼성래미안아파트)",2101,1184,553,605,5,8,1,0,0,2,5,1,0,1,1181,3,917
1388,Guro,투표소,KR3,구로제3동제7투,"L컨벤션(1층, VIP룸)",서울특별시 구로구 디지털로 300(구로동),3635,1043,491,454,12,23,1,4,0,21,8,0,2,9,1025,18,2592
1389,Guro,투표소,KR4,구로제4동제1투,구로4동 구경로당(1층),서울특별시 구로구 구로동로8길 27(구로동),2676,1091,502,546,6,9,0,2,1,5,3,1,1,3,1079,12,1585
1390,Guro,투표소,KR4,구로제4동제2투,"구로구시설관리공단(4층, 꿈나무극장)",서울특별시 구로구 구로동로26길 54(구로동),2263,1001,442,505,5,23,1,2,0,4,4,0,0,3,989,12,1262
1391,Guro,투표소,KR4,구로제4동제3투,두산아파트경로당(1층),"서울특별시 구로구 도림로 59(구로동, 구로두산아파트)",2771,1308,613,647,3,15,0,1,0,7,7,1,0,3,1297,11,1463
1392,Guro,투표소,KR4,구로제4동제4투,"구로제4동주민센터(3층, 강당)",서울특별시 구로구 구로동로28길 94(구로동),2073,752,332,393,4,10,3,1,0,2,2,1,0,0,748,4,1321
1393,Guro,투표소,KR4,구로제4동제5투,"동구로초등학교(체육관동 1층, 영어2)",서울특별시 구로구 구로중앙로14길 43(구로동),3848,1427,604,743,9,22,2,2,0,17,4,1,0,5,1409,18,2421
1394,Guro,투표소,KR4,구로제4동제6투,"동구로초등학교(체육관동 1층, 영어1)",서울특별시 구로구 구로중앙로14길 43(구로동),2015,863,324,501,2,10,0,0,0,8,1,2,1,6,855,8,1152
1395,Guro,투표소,KR5,구로제5동제1투,"리치몰 상가(3층, 웨딩프로포즈 로비)","서울특별시 구로구 구로중앙로 134(구로동, 신구로자이나인스에비뉴)",3028,1341,551,737,5,21,0,5,0,6,1,0,0,6,1332,9,1687
1396,Guro,투표소,KR5,구로제5동제2투,신도림롯데아파트 경로당(1층),"서울특별시 구로구 새말로 31(구로동, 신도림롯데아파트)",3496,2032,829,1154,6,11,1,2,0,8,5,0,1,4,2021,11,1464
1397,Guro,투표소,KR5,구로제5동제3투,"구로구민회관(1층, 갤러리 구루지)",서울특별시 구로구 가마산로25길 21(구로동),3465,1307,574,693,9,11,1,0,0,2,2,1,0,8,1301,6,2158
1398,Guro,투표소,KR5,구로제5동제4투,구로구민회관 로비(1층),서울특별시 구로구 가마산로25길 21(구로동),3947,1383,595,707,6,20,3,4,0,22,6,1,0,8,1372,11,2564
1399,Guro,투표소,KR5,구로제5동제5투,"구로구민생활체육관(1층, 제2교실)",서울특별시 구로구 새말로18길 31(구로동),4607,2077,902,1083,11,22,2,3,0,23,8,0,0,8,2062,15,2530
1400,Guro,투표소,KR5,구로제5동제6투,"미래초등학교(1층, 다목적실)",서울특별시 구로구 새말로 73(구로동),3197,1934,611,1247,8,13,3,4,0,16,7,0,0,7,1916,18,1263
1401,Guro,투표소,KRB,가리봉동제1투,"가리봉동주민센터(1층, 회의실)",서울특별시 구로구 우마2길 35(가리봉동),2183,637,261,349,2,10,2,0,0,1,4,1,0,3,633,4,1546
1402,Guro,투표소,KRB,가리봉동제2투,"구로구가족통합지원센터(2층, 강당)",서울특별시 구로구 우마2길 35(가리봉동),3039,914,363,508,2,18,1,1,1,5,3,0,0,3,905,9,2125
1403,Guro,투표소,KRB,가리봉동제3투,"영일초등학교(1층, 정보화센터)",서울특별시 구로구 남부순환로105길 218(가리봉동),2518,851,392,432,1,7,2,0,0,2,1,1,0,4,842,9,1667
1404,Guro,투표소,KCH1,고척제1동제1투,"고척초등학교(2층, 유희실)",서울특별시 구로구 경서로 31(고척동),3207,1500,508,921,5,18,3,7,0,7,6,0,4,5,1484,16,1707
1405,Guro,투표소,KCH1,고척제1동제2투,"고척중학교(1층, 영어교과실)",서울특별시 구로구 중앙로3길 20(고척동),3200,1522,569,896,3,10,1,4,1,12,4,0,1,5,1506,16,1678
1406,Guro,투표소,KCH1,고척제1동제3투,"고산초등학교(1층, 실과실)",서울특별시 구로구 중앙로 6(고척동),3740,1753,682,998,10,15,3,4,0,15,9,0,0,6,1742,11,1987
1407,Guro,투표소,KCH1,고척제1동제4투,"MG새마을금고(지하1층, 회의실)",서울특별시 구로구 경인로47길 102(고척동),2277,1024,375,602,3,10,4,4,0,8,3,0,1,3,1013,11,1253
1408,Guro,투표소,KCH1,고척제1동제5투,센츄리아파트관리사무소 입주자대표회의실(2층),"서울특별시 구로구 중앙로12길 12(고척동, 센츄리아파트)",3046,1513,573,890,5,12,0,5,0,4,11,0,1,3,1504,9,1533
1409,Guro,투표소,KCH2,고척제2동제1투,"덕의초등학교(1층, 1-6반)",서울특별시 구로구 고척로 213(고척동),2823,1168,487,639,7,11,1,0,0,5,6,2,1,1,1160,8,1655
1410,Guro,투표소,KCH2,고척제2동제2투,"고척고등학교(1층, 강당)",서울특별시 구로구 중앙로15길 162(고척동),2748,1358,551,756,8,20,1,3,0,5,3,1,0,3,1351,7,1390
1411,Guro,투표소,KCH2,고척제2동제3투,"오류중학교(1층, 동아리실)",서울특별시 구로구 고척로27바길 19(고척동),2837,1234,475,708,4,16,0,1,0,8,6,0,0,3,1221,13,1603
1412,Guro,투표소,KCH2,고척제2동제4투,"세곡초등학교(1층, 회의실)",서울특별시 구로구 고척로33길 34(고척동),2519,1017,436,544,4,9,3,1,2,3,6,1,0,4,1013,4,1502
1413,Guro,투표소,KCH2,고척제2동제5투,"세곡 경로당(1층, 여자방)",서울특별시 구로구 고척로52가길 58(고척동),2418,1007,380,578,2,18,1,2,1,7,8,2,0,3,1002,5,1411
1414,Guro,투표소,KCH2,고척제2동제6투,고척대우아파트 경로당(1층),"서울특별시 구로구 고척로52길 48(고척동, 대우아파트)",3121,1663,666,942,10,12,1,4,0,4,6,0,0,3,1648,15,1458
1415,Guro,투표소,KCH2,고척제2동제7투,"고척제2동주민센터(2층, 회의실)",서울특별시 구로구 중앙로15길 22(고척동),1968,932,368,522,9,6,1,1,0,8,5,1,0,5,926,6,1036
1416,Guro,투표소,KB1,개봉제1동제1투,"매봉초등학교(누리터1층, 시청각실)",서울특별시 구로구 고척로21길 55(개봉동),2846,1244,497,706,7,10,1,0,0,6,3,0,0,2,1232,12,1602
1417,Guro,투표소,KB1,개봉제1동제2투,"개봉중학교(별관1층, 한누리관 좌측)",서울특별시 구로구 고척로21나길 68(개봉동),2405,1231,452,728,7,21,0,2,0,5,2,1,0,3,1221,10,1174
1418,Guro,투표소,KB1,개봉제1동제3투,"매봉초등학교(누리터1층, 스마트러닝센터)",서울특별시 구로구 고척로21길 55(개봉동),2399,837,296,513,2,9,1,2,0,1,4,0,0,2,830,7,1562
1419,Guro,투표소,KB1,개봉제1동제4투,"개봉중학교(별관1층, 한누리관 우측)",서울특별시 구로구 고척로21나길 68(개봉동),2364,901,352,513,2,10,1,0,0,9,2,0,3,2,894,7,1463
1420,Guro,투표소,KB1,개봉제1동제5투,"경인중학교(별관1층, 기술실)",서울특별시 구로구 경인로 301(개봉동),3302,1157,417,704,5,10,1,5,0,3,2,1,0,4,1152,5,2145
1421,Guro,투표소,KB1,개봉제1동제6투,"경인중학교(별관1층, 댄스동아리실)",서울특별시 구로구 경인로 301(개봉동),2659,1082,429,604,8,11,0,4,0,7,4,0,0,3,1070,12,1577
1422,Guro,투표소,KB1,개봉제1동제7투,"개봉1동제2자치회관(4층, 다목적실)",서울특별시 구로구 경인로 318-15(개봉동),4013,1889,714,1097,7,19,3,9,0,7,6,3,0,5,1870,19,2124
1423,Guro,투표소,KB1,개봉제1동제8투,한마을아파트 입주자대표회의실(지하1층),"서울특별시 구로구 경인로 382(개봉동, 한마을아파트)",4096,2397,933,1384,9,20,4,3,0,13,7,1,1,7,2382,15,1699
1424,Guro,투표소,KB2,개봉제2동제1투,개봉2동 경로당(2층),서울특별시 구로구 개봉로17나길 62(개봉동),3204,1285,544,681,3,22,1,5,0,13,5,0,1,3,1278,7,1919
1425,Guro,투표소,KB2,개봉제2동제2투,중앙 경로당(1층),서울특별시 구로구 개봉로15길 58-2(개봉동),2800,1228,530,639,6,23,2,2,1,8,6,1,0,2,1220,8,1572
1426,Guro,투표소,KB2,개봉제2동제3투,현대아파트 서부경로당(1층),"서울특별시 구로구 개봉로20길 6(개봉동, 현대아파트1단지)",2481,1522,503,974,4,18,0,2,0,9,2,0,1,5,1518,4,959
1427,Guro,투표소,KB2,개봉제2동제4투,삼환아파트 입주자대표회의실(3층),"서울특별시 구로구 남부순환로95길 54(개봉동, 삼환아파트)",2845,1558,643,863,7,16,1,2,1,9,1,0,0,5,1548,10,1287
1428,Guro,투표소,KB2,개봉제2동제5투,현대아파트 입주자대표회의실(1층),"서울특별시 구로구 개봉로20길 6(개봉동, 현대아파트1단지)",2776,1725,597,1089,8,11,0,2,0,2,2,0,0,3,1714,11,1051
1429,Guro,투표소,KB2,개봉제2동제6투,현대홈타운2단지 경로당(1층),"서울특별시 구로구 개봉로20길 158(개봉동, 현대홈타운2단지)",2686,1531,575,903,5,18,4,5,0,9,3,0,1,1,1524,7,1155
1430,Guro,투표소,KB2,개봉제2동제7투,개봉2동 경로당(1층),서울특별시 구로구 개봉로17나길 62(개봉동),2985,1299,591,645,7,25,1,2,0,11,2,0,0,6,1290,9,1686
1431,Guro,투표소,KB2,개봉제2동제8투,개봉동아이파크 경로당(1층),"서울특별시 구로구 개봉로2길 133-15(개봉동, 개봉동아이파크)",2094,1102,426,631,1,16,1,2,0,6,1,1,0,4,1089,13,992
1432,Guro,투표소,KB3,개봉제3동제1투,"개봉초등학교 도서관동(4층, 멀티미디어실)",서울특별시 구로구 개봉로16길 30-11(개봉동),3338,1333,531,755,2,19,0,1,0,7,4,1,0,6,1326,7,2005
1433,Guro,투표소,KB3,개봉제3동제2투,"개웅중학교(1층, 교과교실-진로실)",서울특별시 구로구 개봉로11길 81(개봉동),3074,1207,487,684,5,7,1,2,0,1,2,0,2,4,1195,12,1867
1434,Guro,투표소,KB3,개봉제3동제3투,"개봉3동자치회관(1층, 다목적실)",서울특별시 구로구 개봉로1가길 28(개봉동),3233,1252,540,657,8,18,1,2,0,4,4,2,1,3,1240,12,1981
1435,Guro,투표소,KB3,개봉제3동제4투,한진아파트 경로당(1층),"서울특별시 구로구 개봉로3길 87(개봉동, 개봉한진아파트)",2626,1518,586,874,8,14,3,2,0,8,1,0,1,6,1503,15,1108
1436,Guro,투표소,KB3,개봉제3동제5투,"개명초등학교 해솔터(1층, 실과실)",서울특별시 구로구 개봉로1다길 16-9(개봉동),2098,835,386,421,3,5,1,1,0,8,0,0,0,3,828,7,1263
1437,Guro,투표소,OR1,오류제1동제1투,"오류1동주민센터(4층, 다목적강당)",서울특별시 구로구 경인로27길 7(오류동),3508,975,411,492,14,12,1,2,0,18,5,0,0,12,967,8,2533
1438,Guro,투표소,OR1,오류제1동제2투,"오류초등학교(본관 4층, 미래교실 1)",서울특별시 구로구 경인로19길 39(오류동),3366,1390,514,806,5,17,0,3,0,13,7,0,0,7,1372,18,1976
1439,Guro,투표소,OR1,오류제1동제3투,"오류초등학교(본관 1층, 로비)",서울특별시 구로구 경인로19길 39(오류동),3607,1506,436,1017,4,19,0,3,0,2,4,1,1,4,1491,15,2101
1440,Guro,투표소,OR1,오류제1동제4투,동부골든(아) 동부경로당(1층),"서울특별시 구로구 고척로 49(오류동, 동부골든아파트)",2688,1548,531,958,8,17,1,5,1,9,1,1,0,5,1537,11,1140
1441,Guro,투표소,OR1,오류제1동제5투,"오류문화센터(3층, 오류골사랑방)",서울특별시 구로구 경인로20가길 38(오류동),3200,1363,549,740,7,19,0,8,0,11,7,2,1,3,1347,16,1837
1442,Guro,투표소,OR2,오류제2동제1투,"오류2동 자치회관 별관[구)치안센터](1층, 회의실)",서울특별시 구로구 오류로 71(오류동),3472,1580,591,923,5,23,0,3,0,10,5,4,2,2,1568,12,1892
1443,Guro,투표소,OR2,오류제2동제2투,"오류보건지소(3층, 다목적실)",서울특별시 구로구 오리로10길 44-3(오류동),3498,1580,526,988,8,15,0,8,0,12,3,0,1,6,1567,13,1918
1444,Guro,투표소,OR2,오류제2동제3투,"덕일전자공업고등학교(반지하1층, 회의실)",서울특별시 구로구 서해안로21길 5-12(오류동),3400,1773,623,1090,5,17,1,4,0,8,6,2,1,4,1761,12,1627
1445,Guro,투표소,OR2,오류제2동제4투,"오남중학교(1층, 무용실)",서울특별시 구로구 오리로9길 25(오류동),2763,1306,501,746,8,22,0,3,0,6,7,0,1,6,1300,6,1457
1446,Guro,투표소,OR2,오류제2동제5투,"서울오정초등학교(2층, 강당)",서울특별시 구로구 경인로2길 10(오류동),2429,1093,443,612,7,7,0,2,0,6,3,2,0,5,1087,6,1336
1447,Guro,투표소,OR2,오류제2동제6투,"천왕중학교(1층, 가정실)",서울특별시 구로구 천왕로 63(천왕동),3313,1612,705,846,13,16,0,6,0,6,7,0,1,2,1602,10,1701
1448,Guro,투표소,OR2,오류제2동제7투,"서울천왕초등학교(2층, 강당)",서울특별시 구로구 천왕로1길 11(천왕동),3645,1861,905,879,4,22,0,4,0,11,12,1,2,8,1848,13,1784
1449,Guro,투표소,OR2,오류제2동제8투,"서울하늘숲초등학교(1층, 체육관)",서울특별시 구로구 오리로 1106(천왕동),2751,1398,672,675,6,15,3,2,0,6,5,0,2,7,1393,5,1353
1450,Guro,투표소,SK,수궁동제1투,"구로청소년문화의집(지하1층, 대강당)",서울특별시 구로구 부일로 949(궁동),2894,1437,304,1094,9,10,2,2,0,4,1,0,2,1,1429,8,1457
1451,Guro,투표소,SK,수궁동제2투,"세종과학고등학교(2층, 체육관)",서울특별시 구로구 오리로21길 79(궁동),2836,1310,420,837,5,16,1,1,0,7,2,0,0,6,1295,15,1526
1452,Guro,투표소,SK,수궁동제3투,"오류고등학교(1층, 과학교실)",서울특별시 구로구 오리로21길 2(궁동),3751,1773,625,1086,6,23,0,6,1,11,2,1,0,5,1766,7,1978
1453,Guro,투표소,SK,수궁동제4투,"서울정진학교 중등동(1층, 3-1반)",서울특별시 구로구 부일로9길 158(궁동),2568,1464,553,867,7,16,0,3,0,8,0,0,0,4,1458,6,1104
1454,Guro,투표소,SK,수궁동제5투,"온수초등학교(1층, 영어교실)",서울특별시 구로구 부일로 893(온수동),3236,1437,559,810,2,25,1,3,0,9,5,4,0,7,1425,12,1799
1455,Guro,투표소,SK,수궁동제6투,구로구립장애인보호작업장(1층),서울특별시 구로구 경인로 21(온수동),1329,671,239,402,4,9,2,2,1,4,0,1,0,5,669,2,658
1456,Guro,투표소,H,항동제1투,"항동중학교(2층, 체육관)",서울특별시 구로구 연동로 239-2(항동),3649,1857,749,1028,9,31,0,1,0,4,9,0,0,7,1838,19,1792
1457,Guro,투표소,H,항동제2투,"항동생활체육관(2층, 다목적체육관)",서울특별시 구로구 항동로 24(항동),2797,1395,619,704,13,20,3,5,1,8,8,0,0,9,1390,5,1402
1458,Guro,투표소,H,항동제3투,"항동주민센터(3층, 회의실)",서울특별시 구로구 서해안로 2102솔보프라자 3층 (항동),2621,1217,560,601,6,12,1,3,0,4,10,1,0,6,1204,13,1404
1459,Geumcheon,투표소,KS,가산동제1투,"가산동주민센터(2층, 문화관람실)",서울특별시 금천구 가산로 129(가산동),3977,1181,486,582,12,16,3,4,0,27,8,0,0,14,1152,29,2796
1460,Geumcheon,투표소,KS,가산동제2투,"가산초등학교(1층, 보건교육실)",서울특별시 금천구 남부순환로 1304-11(독산동),4345,1268,551,608,10,28,4,8,0,28,3,2,0,5,1247,21,3077
1461,Geumcheon,투표소,KS,가산동제3투,"두산위브아파트(1층, A지역 경로당)",서울특별시 금천구 가산로 99(가산동),3103,1508,580,871,6,12,2,6,1,7,2,1,1,4,1493,15,1595
1462,Geumcheon,투표소,KS,가산동제4투,우정경로당(1층),서울특별시 금천구 두산로3길 49(가산동),3546,1205,521,595,10,21,3,8,0,16,7,1,0,6,1188,17,2341
1463,Geumcheon,투표소,KS,가산동제5투,"스타밸리(지하1층, 입주자대표회의실)",서울특별시 금천구 디지털로9길 99(가산동),1238,424,183,226,3,7,0,1,0,1,1,0,0,0,422,2,814
1464,Geumcheon,투표소,KS,가산동제6투,"에이스하이엔드타워 3차(1층, 입주자회의실)",서울특별시 금천구 가산디지털1로 145(가산동),2427,762,357,340,4,12,2,4,0,28,5,1,0,4,757,5,1665
1465,Geumcheon,투표소,DS1,독산제1동제1투,"독산1동주민센터(3층, 마을활력소)",서울특별시 금천구 시흥대로123길 11(독산동),4212,1228,540,622,4,24,1,3,0,10,4,1,0,5,1214,14,2984
1466,Geumcheon,투표소,DS1,독산제1동제2투,영보경로문화센터(1층 경로당),서울특별시 금천구 시흥대로141길 61-1(독산동),3060,952,422,456,9,18,1,6,0,15,5,1,1,6,940,12,2108
1467,Geumcheon,투표소,DS1,독산제1동제3투,"두산초등학교(1층, 멀티미디어실)",서울특별시 금천구 범안로11길 3(독산동),6059,2065,904,1032,7,30,6,11,1,28,14,0,0,12,2045,20,3994
1468,Geumcheon,투표소,DS1,독산제1동제4투,"금천현대아파트(1층, 경로당)",서울특별시 금천구 벚꽃로 73(독산동),3619,1868,753,1050,6,16,1,1,0,10,7,2,1,7,1854,14,1751
1469,Geumcheon,투표소,DS1,독산제1동제5투,"안천중학교(1층, 정보화센터)",서울특별시 금천구 한내로 69-44(독산동),3150,1658,762,842,4,16,1,3,1,4,2,1,2,4,1642,16,1492
1470,Geumcheon,투표소,DS1,독산제1동제6투,"한신아파트(1층, 경로당)",서울특별시 금천구 한내로 62(독산동),3924,2168,831,1266,7,25,3,6,0,11,3,2,0,7,2161,7,1756
1471,Geumcheon,투표소,DS1,독산제1동제7투,롯데캐슬골드파크1차아파트 캐슬리언센터 로비(1층),"서울특별시 금천구 벚꽃로 40(독산동, 금천롯데캐슬골드파크1차아파트)",4318,2508,936,1477,14,23,5,7,1,24,6,1,0,6,2500,8,1810
1472,Geumcheon,투표소,DS1,독산제1동제8투,금천롯데캐슬골드파크3차아파트 작은도서관(4층),"서울특별시 금천구 시흥대로 291(독산동, 금천롯데캐슬골드파크3차)",3242,1774,695,1008,10,17,2,3,0,17,4,1,0,5,1762,12,1468
1473,Geumcheon,투표소,DS2,독산제2동제1투,"독산초등학교(1층, 소강당 1실)",서울특별시 금천구 시흥대로104길 31(독산동),2296,892,362,482,6,21,1,0,1,5,4,0,0,2,884,8,1404
1474,Geumcheon,투표소,DS2,독산제2동제2투,"독산초등학교 본관(1층, 교사식당)",서울특별시 금천구 시흥대로104길 31(독산동),2465,888,349,510,5,11,0,2,0,2,2,0,0,2,883,5,1577
1475,Geumcheon,투표소,DS2,독산제2동제3투,"(주)다성애드(1층, 위너스골프장 옆)",서울특별시 금천구 시흥대로 288-8(독산동),2201,790,348,406,3,11,0,2,0,7,1,1,0,2,781,9,1411
1476,Geumcheon,투표소,DS2,독산제2동제4투,독산2동주민센터 대강당(5층),서울특별시 금천구 독산로 179(독산동),2306,846,369,447,3,11,1,2,1,4,3,0,0,1,842,4,1460
1477,Geumcheon,투표소,DS2,독산제2동제5투,"독산2동주민센터(3층, 다목적실)",서울특별시 금천구 독산로 179(독산동),2365,821,367,429,1,8,0,0,1,4,2,0,0,2,814,7,1544
1478,Geumcheon,투표소,DS2,독산제2동제6투,"독산도서관(3층, 열람실)",서울특별시 금천구 독산로54길 114(독산동),2486,903,385,481,6,11,0,2,1,3,1,0,1,3,894,9,1583
1479,Geumcheon,투표소,DS3,독산제3동제1투,"모두의학교(1층, 다목적홀)",서울특별시 금천구 남부순환로128길 42(독산동),3435,1362,575,716,6,21,0,4,0,15,8,0,1,4,1350,12,2073
1480,Geumcheon,투표소,DS3,독산제3동제2투,"난곡중학교(1층, 음악실앞 로비)",서울특별시 금천구 문성로 67(독산동),3303,1315,551,701,8,20,1,3,0,4,7,2,2,5,1304,11,1988
1481,Geumcheon,투표소,DS3,독산제3동제3투,"독산3동주민센터(4층, 대강당)",서울특별시 금천구 독산로 317(독산동),3362,1282,569,647,6,19,2,5,0,8,8,2,1,3,1270,12,2080
1482,Geumcheon,투표소,DS3,독산제3동제4투,"독산3동주민센터(3층, 1강의실)",서울특별시 금천구 독산로 317(독산동),2991,797,335,422,4,13,0,9,0,7,3,0,0,1,794,3,2194
1483,Geumcheon,투표소,DS3,독산제3동제5투,"문성초등학교(1층, 보건교육실)",서울특별시 금천구 시흥대로 460(독산동),2751,995,415,533,2,14,2,0,0,13,1,0,0,3,983,12,1756
1484,Geumcheon,투표소,DS3,독산제3동제6투,구룡경로당(1층),서울특별시 금천구 남부순환로122길 5(독산동),3133,1262,541,654,10,18,2,4,0,16,1,1,0,7,1254,8,1871
1485,Geumcheon,투표소,DS4,독산제4동제1투,"독산4동주민센터(1층, 모두공간)",서울특별시 금천구 독산로 232(독산동),2914,987,425,518,3,11,0,3,1,9,5,0,1,1,977,10,1927
1486,Geumcheon,투표소,DS4,독산제4동제2투,"독산4동주민센터(5층, 문화관람실)",서울특별시 금천구 독산로 232(독산동),3050,1041,433,583,1,9,1,4,1,2,3,0,0,1,1038,3,2009
1487,Geumcheon,투표소,DS4,독산제4동제3투,"금천구민문화체육센터(1층, 체육관)",서울특별시 금천구 독산로54길 188(독산동),2278,784,340,417,2,7,1,1,1,5,2,0,0,2,778,6,1494
1488,Geumcheon,투표소,DS4,독산제4동제4투,"금천구민문화체육센터(1층, 다목적실)",서울특별시 금천구 독산로54길 188(독산동),3067,1204,553,603,8,11,0,2,2,9,1,0,0,5,1194,10,1863
1489,Geumcheon,투표소,SH1,시흥제1동제1투,"금천구청 금나래아트홀(1층, 갤러리)",서울특별시 금천구 시흥대로73길 70(시흥동),2905,1269,521,681,9,24,1,1,0,7,3,1,0,8,1256,13,1636
1490,Geumcheon,투표소,SH1,시흥제1동제2투,"문일고등학교(1층, 전자도서관)",서울특별시 금천구 시흥대로47길 45(시흥동),3814,1589,614,907,8,19,0,5,0,15,2,0,1,7,1578,11,2225
1491,Geumcheon,투표소,SH1,시흥제1동제3투,"문백초등학교(1층, 꿈나래3)",서울특별시 금천구 시흥대로47길 43-1(시흥동),2634,1417,524,852,5,12,3,4,0,6,2,1,0,0,1409,8,1217
1492,Geumcheon,투표소,SH1,시흥제1동제4투,시흥초등학교 체육관(1층),서울특별시 금천구 독산로23길 26(시흥동),2513,722,317,376,2,6,0,2,0,4,1,0,1,2,711,11,1791
1493,Geumcheon,투표소,SH1,시흥제1동제5투,"시흥초등학교(1층, 체육관)",서울특별시 금천구 독산로23길 26(시흥동),2721,924,332,540,6,17,3,2,0,6,4,1,1,3,915,9,1797
1494,Geumcheon,투표소,SH1,시흥제1동제6투,"힐탑아파트(2층, 주차장)",서울특별시 금천구 시흥대로 254(시흥동),2453,903,398,471,3,9,0,2,0,3,3,0,0,4,893,10,1550
1495,Geumcheon,투표소,SH1,시흥제1동제7투,"시흥초등학교(1층, 체육관)",서울특별시 금천구 독산로23길 26(시흥동),2274,878,366,474,1,11,1,1,2,8,1,0,0,5,870,8,1396
1496,Geumcheon,투표소,SH1,시흥제1동제8투,"시흥1동주민센터(2층, 회의실)",서울특별시 금천구 시흥대로58길 36(시흥동),2921,932,368,515,5,10,4,5,0,5,4,0,0,6,922,10,1989
1497,Geumcheon,투표소,SH1,시흥제1동제9투,"남서울힐스테이트아파트(1층, 경로당)","서울특별시 금천구 시흥대로 165(시흥동, 남서울힐스테이트아파트)",1972,1088,401,656,2,8,0,4,0,6,4,0,0,2,1083,5,884
1498,Geumcheon,투표소,SH2,시흥제2동제1투,"탑동초등학교(1층, 보건교육실)",서울특별시 금천구 탑골로 47-3(시흥동),2155,863,345,486,3,7,1,1,0,10,0,0,0,2,855,8,1292
1499,Geumcheon,투표소,SH2,시흥제2동제2투,"벽산2단지아파트C상가(3층, 한맥태권도장)",서울특별시 금천구 금하로 793(시흥동),2337,1213,513,663,8,8,0,2,0,9,2,0,0,2,1207,6,1124
1500,Geumcheon,투표소,SH2,시흥제2동제3투,벽산1단지 벽산경로당(1층),서울특별시 금천구 금하로 793(시흥동),2641,1572,538,986,9,10,1,4,0,10,3,0,0,4,1565,7,1069
1501,Geumcheon,투표소,SH2,시흥제2동제4투,"벽산5단지 경로당(1층, 508동 옆)",서울특별시 금천구 금하로 816(시흥동),2799,1587,617,930,8,10,2,2,0,10,0,0,0,4,1583,4,1212
1502,Geumcheon,투표소,SH2,시흥제2동제5투,"금동초등학교(1층, 1-2반)",서울특별시 금천구 금하로30길 53(시흥동),2584,1309,614,663,3,9,2,4,0,5,2,0,0,2,1304,5,1275
1503,Geumcheon,투표소,SH2,시흥제2동제6투,벽산6단지 경로당(1층),서울특별시 금천구 금하로 796(시흥동),1722,814,335,434,3,17,4,2,0,7,1,1,0,3,807,7,908
1504,Geumcheon,투표소,SH3,시흥제3동제1투,"시흥3동주민센터(지하1층, 문화관람실)",서울특별시 금천구 시흥대로18길 40(시흥동),2602,1118,430,633,9,23,2,2,0,2,2,2,0,5,1110,8,1484
1505,Geumcheon,투표소,SH3,시흥제3동제2투,"금천고등학교 정보화센터(지하1층, 어울마당)",서울특별시 금천구 시흥대로38길 26(시흥동),1888,815,351,422,6,7,1,4,0,7,1,0,0,8,807,8,1073
1506,Geumcheon,투표소,SH3,시흥제3동제3투,"박미사랑 마을회관(지하1층, 다목적홀)",서울특별시 금천구 시흥대로18길 65-4(시흥동),1912,829,303,493,8,9,0,1,0,5,1,1,0,1,822,7,1083
1507,Geumcheon,투표소,SH3,시흥제3동제4투,하누리 주간보호센터(1층),서울특별시 금천구 시흥대로2길 57(시흥동),1196,670,265,377,3,11,1,4,0,3,0,1,0,1,666,4,526
1508,Geumcheon,투표소,SH4,시흥제4동제1투,"보훈회관(1층, 구 금천장애인연합회)",서울특별시 금천구 독산로24길 39(시흥동),2799,1074,451,583,4,15,0,3,0,6,4,0,0,3,1069,5,1725
1509,Geumcheon,투표소,SH4,시흥제4동제2투,"시흥4동주민센터(4층, 문화관람실)",서울특별시 금천구 독산로36길 14(시흥동),2205,765,317,414,2,9,3,2,0,7,3,1,1,3,762,3,1440
1510,Geumcheon,투표소,SH4,시흥제4동제3투,"순흥안씨양도공파종회(1층, 강당)",서울특별시 금천구 독산로36나길 57(시흥동),2029,872,361,489,4,9,2,1,0,2,1,0,0,0,869,3,1157
1511,Geumcheon,투표소,SH4,시흥제4동제4투,"남부여성발전센터 교육관(1층, 102호)",서울특별시 금천구 독산로50길 23(시흥동),2572,1285,504,733,10,5,5,1,0,9,6,1,0,7,1281,4,1287
1512,Geumcheon,투표소,SH4,시흥제4동제5투,"신흥초등학교(1층, 토론연수실)",서울특별시 금천구 독산로36나길 21(시흥동),2518,942,371,527,5,16,0,2,0,8,2,1,1,3,936,6,1576
1513,Geumcheon,투표소,SH4,시흥제4동제6투,"한울중학교 배움터(1층, 로비)",서울특별시 금천구 독산로50길 60(시흥동),2618,1031,433,555,5,15,2,3,0,3,3,1,3,1,1024,7,1587
1514,Geumcheon,투표소,SH5,시흥제5동제1투,"금천초등학교(1층, 숲속 꿈꾸는 교실)",서울특별시 금천구 탑골로5길 60(시흥동),2376,877,336,496,3,15,1,0,0,5,2,2,0,5,865,12,1499
1515,Geumcheon,투표소,SH5,시흥제5동제2투,"시흥5동주민센터(2층, 문화관람실)",서울특별시 금천구 금하로21길 20(시흥동),3135,1144,461,616,8,24,1,5,1,9,5,1,0,3,1134,10,1991
1516,Geumcheon,투표소,SH5,시흥제5동제3투,"건영아파트 (경로당,1층)","서울특별시 금천구 독산로10길 96(시흥동, 건영아파트)",3163,1486,601,834,3,11,1,3,0,10,3,0,0,5,1471,15,1677
1517,Geumcheon,투표소,SH5,시흥제5동제4투,"마을공동체지원센터(1층, 경청마루)",서울특별시 금천구 은행나무로 45(시흥동),2685,1032,417,567,3,22,1,2,0,5,2,0,0,6,1025,7,1653
1518,Geumcheon,투표소,SH5,시흥제5동제5투,"백산초등학교(1층, 꿈누리관)",서울특별시 금천구 시흥대로38길 78(시흥동),2425,968,378,558,3,10,0,2,1,5,1,0,0,4,962,6,1457
1519,Yeongdeunpo,투표소,YDPB,영등포본동제1투,"영원중학교(지하1층, 학생식당)",서울특별시 영등포구 영등포로62길 31(영등포동),2527,1189,409,739,4,11,1,2,0,5,1,1,1,3,1177,12,1338
1520,Yeongdeunpo,투표소,YDPB,영등포본동제2투,"장훈고등학교(2동 1층, 일시적관찰실)",서울특별시 영등포구 영등포로64길 26(신길동),2130,848,302,510,4,19,0,0,0,3,1,0,1,2,842,6,1282
1521,Yeongdeunpo,투표소,YDPB,영등포본동제3투,"장훈고등학교(2동 1층, 독도영상학습관 앞 복도)",서울특별시 영등포구 영등포로64길 26(신길동),1594,527,185,321,1,6,1,3,0,0,1,0,0,3,521,6,1067
1522,Yeongdeunpo,투표소,YDPB,영등포본동제4투,"영등포본동주민센터(4층, 대강당)",서울특별시 영등포구 신길로61길 17(영등포동),1981,686,249,416,2,4,1,2,1,1,2,1,0,3,682,4,1295
1523,Yeongdeunpo,투표소,YDPB,영등포본동제5투,영등포본동구립경로당(1층),서울특별시 영등포구 영신로9나길 7(영등포동),1399,531,196,312,1,5,0,0,0,4,2,1,1,1,523,8,868
1524,Yeongdeunpo,투표소,YDPB,영등포본동제6투,영원초등학교 종합정보실 앞 복도(1층),서울특별시 영등포구 도영로22길 31(영등포동),2510,1393,543,808,6,16,1,3,0,3,2,0,0,5,1387,6,1117
1525,Yeongdeunpo,투표소,YDPB,영등포본동제7투,영등포푸르지오아파트2단지경로당(1층),"서울특별시 영등포구 도신로29길 28(영등포동, 영등포푸르지오)",2925,1787,660,1052,7,20,3,5,0,15,3,0,0,6,1771,16,1138
1526,Yeongdeunpo,투표소,YDP,영등포동제1투,"영등포동주민센터(2층, 회의실)",서울특별시 영등포구 영등포로53길 22(영등포동2가),4723,1419,493,801,13,22,2,6,0,32,11,0,0,10,1390,29,3304
1527,Yeongdeunpo,투표소,YDP,영등포동제2투,"K1빌딩 한국마사회(1층, 문화공감센터)",서울특별시 영등포구 영중로8길 14(영등포동3가),3994,1187,500,616,9,26,2,3,1,13,4,0,0,4,1178,9,2807
1528,Yeongdeunpo,투표소,YDP,영등포동제3투,"영중초등학교(1층, 제1과학실)",서울특별시 영등포구 양산로 185(영등포동7가),3131,1432,554,805,8,19,2,5,0,14,1,3,0,11,1422,10,1699
1529,Yeongdeunpo,투표소,YDP,영등포동제4투,"서울시립장애인복지관(1층, 룸비니홀)",서울특별시 영등포구 버드나루로 22(영등포동2가),3324,1001,360,570,8,9,3,7,0,18,1,0,0,12,988,13,2323
1530,Yeongdeunpo,투표소,YDP,영등포동제5투,"영등포동자치회관(2층, 제2강의실)",서울특별시 영등포구 국회대로44길 4(영등포동7가),3372,1450,425,955,11,18,2,4,0,19,3,0,0,2,1439,11,1922
1531,Yeongdeunpo,투표소,YDP,영등포동제6투,"아크로타워스퀘어아파트(1층, 103동 로비)","서울특별시 영등포구 국회대로54길 10(영등포동7가, 아크로타워 스퀘어)",2660,1636,450,1120,12,16,2,4,0,11,1,1,0,10,1627,9,1024
1532,Yeongdeunpo,투표소,YI,여의동제1투,"여의도시범아파트 관리사무소(1층, 관리사무소)","서울특별시 영등포구 63로 45(여의도동, 여의도시범아파트)",2717,1588,328,1222,5,10,1,4,0,5,2,0,0,5,1582,6,1129
1533,Yeongdeunpo,투표소,YI,여의동제2투,"여의동주민센터(4층, 다목적회의실)",서울특별시 영등포구 국제금융로 124(여의도동),3020,1555,253,1275,3,3,0,2,0,4,3,0,0,3,1546,9,1465
1534,Yeongdeunpo,투표소,YI,여의동제3투,"여의도여자고등학교(1층, 무용실)",서울특별시 영등포구 국제금융로7가길 13(여의도동),2624,1588,293,1264,4,8,4,1,0,2,0,0,0,9,1585,3,1036
1535,Yeongdeunpo,투표소,YI,여의동제4투,"여의도중학교(1층, 소회의실)",서울특별시 영등포구 국제금융로7길 46(여의도동),2542,1441,228,1179,6,8,3,1,0,5,2,0,0,6,1438,3,1101
1536,Yeongdeunpo,투표소,YI,여의동제5투,"여의도중학교(1층, 기술실)",서울특별시 영등포구 국제금융로7길 46(여의도동),2560,1538,280,1216,9,5,0,3,0,10,0,0,1,4,1528,10,1022
1537,Yeongdeunpo,투표소,YI,여의동제6투,"윤중초등학교(1층, 튼튼이방)",서울특별시 영등포구 여의나루로2길 14(여의도동),2852,1690,283,1362,7,9,4,7,0,7,0,1,0,5,1685,5,1162
1538,Yeongdeunpo,투표소,YI,여의동제7투,"윤중중학교(1층, 도서실)",서울특별시 영등포구 여의동로3길 3(여의도동),3329,1982,267,1675,3,4,2,3,0,11,1,0,1,6,1973,9,1347
1539,Yeongdeunpo,투표소,YI,여의동제8투,"여의도더샵아일랜드파크(1층, 클럽하우스)",서울특별시 영등포구 의사당대로 38(여의도동),2162,1075,309,736,4,4,3,1,0,5,3,0,1,3,1069,6,1087
1540,Yeongdeunpo,투표소,DS1,당산제1동제1투,당산1가경로당(1층),서울특별시 영등포구 영등포로29길 13(당산동1가),1804,791,296,449,3,10,1,2,0,9,5,1,2,3,781,10,1013
1541,Yeongdeunpo,투표소,DS1,당산제1동제2투,당산1동주민센터(2층),서울특별시 영등포구 양산로23길 11(당산동3가),3205,1390,512,787,15,20,2,7,0,23,1,0,1,8,1376,14,1815
1542,Yeongdeunpo,투표소,DS1,당산제1동제3투,현대아파트 후문 경로당(1층),"서울특별시 영등포구 당산로 95(당산동2가, 현대아파트)",3045,1663,576,1014,10,15,0,3,0,19,3,1,1,9,1651,12,1382
1543,Yeongdeunpo,투표소,DS1,당산제1동제4투,"영등포아트홀 (2층, 강의실)",서울특별시 영등포구 국회대로 596(당산동3가),3794,1595,473,1034,12,30,3,0,0,12,6,0,0,6,1576,19,2199
1544,Yeongdeunpo,투표소,DS1,당산제1동제5투,구청별관 G동 자기주도학습지원센터(1층),서울특별시 영등포구 선유동1로 80(당산동3가),2722,1311,477,782,9,14,1,2,1,8,1,0,0,7,1302,9,1411
1545,Yeongdeunpo,투표소,DS2,당산제2동제1투,경륜경정사업본부 영등포지점(4층),서울특별시 영등포구 양평로 48(당산동6가),4512,1831,617,1079,34,20,5,3,1,27,10,1,1,12,1810,21,2681
1546,Yeongdeunpo,투표소,DS2,당산제2동제2투,"당산서중학교(본관동1층, 다목적실)",서울특별시 영등포구 당산로41길 12(당산동5가),3434,1665,547,1053,7,10,4,4,0,12,4,0,0,10,1651,14,1769
1547,Yeongdeunpo,투표소,DS2,당산제2동제3투,"반도유보라팰리스(1층, 경로당)","서울특별시 영등포구 국회대로 597(당산동4가, 당산동 반도유보라팰리스)",4227,2082,688,1310,17,19,1,2,0,14,4,1,0,10,2066,16,2145
1548,Yeongdeunpo,투표소,DS2,당산제2동제4투,"당산센트럴아이파크(지하1층, 스포츠센터 다목적실)","서울특별시 영등포구 영신로 247(당산동5가, 당산센트럴아이파크)",4330,2509,812,1613,13,21,4,5,0,15,6,0,0,6,2495,14,1821
1549,Yeongdeunpo,투표소,DS2,당산제2동제5투,"삼성래미안4차아파트(지하1층, 입주자대표회의실)","서울특별시 영등포구 당산로 214(당산동5가, 당산 삼성 래미안)",3199,2054,470,1535,5,19,2,2,0,6,0,0,1,6,2046,8,1145
1550,Yeongdeunpo,투표소,DS2,당산제2동제6투,"당산중학교 (1층, 은하수실)",서울특별시 영등포구 버드나루로 160(당산동),3426,1841,579,1172,11,18,2,4,0,23,5,0,0,13,1827,14,1585
1551,Yeongdeunpo,투표소,DS2,당산제2동제7투,"영동초등학교(1층, 보건교육실)",서울특별시 영등포구 국회대로53길 20(당산동),2275,974,413,470,13,15,5,2,0,26,3,0,0,10,957,17,1301
1552,Yeongdeunpo,투표소,DR,도림동제1투,도림동 자치회관(1층),서울특별시 영등포구 도신로33길 4(도림동),3426,1387,523,809,5,15,0,4,1,4,4,1,1,6,1373,14,2039
1553,Yeongdeunpo,투표소,DR,도림동제2투,모랫말어르신복지센터(4층),서울특별시 영등포구 도영로 41(도림동),2980,1047,390,617,3,15,1,2,0,5,4,0,0,1,1038,9,1933
1554,Yeongdeunpo,투표소,DR,도림동제3투,"도림동주민센터(3층,소통마당)",서울특별시 영등포구 도영로7길 10(도림동),3464,1371,576,719,14,18,2,4,0,12,3,0,0,7,1355,16,2093
1555,Yeongdeunpo,투표소,DR,도림동제4투,영등포아트자이아파트(주민공동시설내 탁구장),"서울특별시 영등포구 도영로 66(도림동, 영등포아트자이아파트)",3357,1664,661,935,7,24,2,8,0,9,8,0,1,4,1659,5,1693
1556,Yeongdeunpo,투표소,ML,문래동제1투,"영등포초등학교(1층, 체육관)",서울특별시 영등포구 경인로 756(문래동1가),1795,611,197,394,4,6,0,2,0,2,1,0,0,2,608,3,1184
1557,Yeongdeunpo,투표소,ML,문래동제2투,"문래힐스테이트 아파트(지하1층, 탁구실)","서울특별시 영등포구 문래로 82(문래동3가, 문래힐스테이트)",2178,1376,410,934,4,8,0,2,0,6,2,0,0,2,1368,8,802
1558,Yeongdeunpo,투표소,ML,문래동제3투,"문래초등학교(1층, 연수실)",서울특별시 영등포구 문래로 104(문래동3가),3223,1587,616,906,11,12,3,4,1,9,4,0,0,6,1572,15,1636
1559,Yeongdeunpo,투표소,ML,문래동제4투,"문래자이아파트(1층, 경로당)","서울특별시 영등포구 당산로4길 12(문래동3가, 문래자이)",2454,1576,369,1166,3,10,1,4,0,8,2,1,2,4,1570,6,878
1560,Yeongdeunpo,투표소,ML,문래동제5투,영등포노인종합복지관(1층),서울특별시 영등포구 도림로 482(문래동3가),3673,1910,757,1068,9,21,1,5,0,15,3,1,1,10,1891,19,1763
1561,Yeongdeunpo,투표소,ML,문래동제6투,"영문초등학교(1층, 1-1반 교실 앞 복도)",서울특별시 영등포구 문래로 56(문래동6가),4285,2238,981,1136,22,19,2,8,2,20,7,0,2,17,2216,22,2047
1562,Yeongdeunpo,투표소,ML,문래동제7투,"문래중학교(1층, 무용실)",서울특별시 영등포구 선유서로13길 6(문래동6가),3575,2075,888,1110,5,34,1,4,0,11,2,1,1,8,2065,10,1500
1563,Yeongdeunpo,투표소,YP1,양평제1동제1투,"당중초등학교(2층, 식당)",서울특별시 영등포구 선유로 131(양평동3가),2155,873,319,517,4,11,3,2,0,7,4,0,0,3,870,3,1282
1564,Yeongdeunpo,투표소,YP1,양평제1동제2투,"관악고등학교 (1층, 미술실)",서울특별시 영등포구 영등포로6길 26(양평동2가),3292,1569,609,897,9,12,4,5,0,16,4,0,0,7,1563,6,1723
1565,Yeongdeunpo,투표소,YP1,양평제1동제3투,"양평동 주민복지회관(5층, 다목적회의실)",서울특별시 영등포구 선유서로34길 10(양평동3가),3450,1358,501,774,15,23,2,4,0,11,7,1,0,6,1344,14,2092
1566,Yeongdeunpo,투표소,YP1,양평제1동제4투,"서울당중초등학교(1층, 급식실)",서울특별시 영등포구 선유로 131(양평동3가),2766,1272,502,703,8,23,3,3,0,0,13,3,0,4,1262,10,1494
1567,Yeongdeunpo,투표소,YP2,양평제2동제1투,"선유중학교 (1층, 102호실)",서울특별시 영등포구 선유로 213(양평동3가),2714,1399,556,793,11,5,2,5,0,10,3,2,1,4,1392,7,1315
1568,Yeongdeunpo,투표소,YP2,양평제2동제2투,"선유고등학교(1층, 진로상담실 앞 복도)",서울특별시 영등포구 선유로 227(양평동4가),2632,1261,463,738,10,19,4,1,0,9,1,1,0,5,1251,10,1371
1569,Yeongdeunpo,투표소,YP2,양평제2동제3투,"한강미디어고등학교(어울마당동 2층, 체육실)",서울특별시 영등포구 선유로55길 22(양평동4가),2788,1086,394,633,7,17,1,2,0,12,7,1,0,7,1081,5,1702
1570,Yeongdeunpo,투표소,YP2,양평제2동제4투,"한신아파트(1층, 경로당)","서울특별시 영등포구 양평로24길 9(양평동5가, 양평동한신아파트)",2819,1643,617,962,10,17,0,5,0,11,4,1,2,6,1635,8,1176
1571,Yeongdeunpo,투표소,YP2,양평제2동제5투,"당산초등학교(1층, 영어2반 교실)",서울특별시 영등포구 선유로55길 32(양평동4가),3592,1527,587,867,15,10,2,5,0,12,6,0,0,8,1512,15,2065
1572,Yeongdeunpo,투표소,SK1,신길제1동제1투,"한국제과학교(1층, 제3실습실)",서울특별시 영등포구 여의대방로61길 42(신길동),3297,1327,521,719,8,21,6,5,0,14,9,0,0,9,1312,15,1970
1573,Yeongdeunpo,투표소,SK1,신길제1동제2투,"영신초등학교 (1층, 돌봄2반)",서울특별시 영등포구 도신로60길 23(신길동),2768,1016,379,578,4,13,2,3,0,14,3,1,0,4,1001,15,1752
1574,Yeongdeunpo,투표소,SK1,신길제1동제3투,"신길1동주민센터(2층, 다목적회의실)",서울특별시 영등포구 영등포로84길 24-5(신길동),2933,1105,416,619,10,18,1,8,1,12,6,1,1,2,1095,10,1828
1575,Yeongdeunpo,투표소,SK1,신길제1동제4투,"영신초등학교(1층, 과학실)",서울특별시 영등포구 도신로60길 23(신길동),2834,1221,426,728,12,17,1,1,0,9,0,1,1,7,1203,18,1613
1576,Yeongdeunpo,투표소,SK1,신길제1동제5투,"영신초등학교(2층, 강당)",서울특별시 영등포구 도신로60길 23(신길동),1238,535,181,333,1,12,0,0,0,2,1,1,0,2,533,2,703
1577,Yeongdeunpo,투표소,SK3,신길제3동제1투,"도림초등학교(1층, Lab 1실)",서울특별시 영등포구 가마산로65길 22(신길동),2242,840,301,506,8,9,2,0,0,6,0,0,0,1,833,7,1402
1578,Yeongdeunpo,투표소,SK3,신길제3동제2투,"신길제3동주민센터(2층, 회의실)",서울특별시 영등포구 신길로41라길 13-8(신길동),2378,909,341,533,6,15,1,4,0,2,1,1,0,1,905,4,1469
1579,Yeongdeunpo,투표소,SK3,신길제3동제3투,"신길우성1차아파트 경로당(1층, 마님방,로비)","서울특별시 영등포구 도신로 68(신길동, 신길우성아파트)",2337,1361,497,825,2,13,3,0,0,6,5,0,0,5,1356,5,976
1580,Yeongdeunpo,투표소,SK3,신길제3동제4투,신길센트럴아이파크아파트 경로당(1층),"서울특별시 영등포구 가마산로 426(신길동, 신길센트럴아이파크)",2616,1276,450,768,5,22,0,4,0,7,5,1,2,4,1268,8,1340
1581,Yeongdeunpo,투표소,SK3,신길제3동제5투,"도림신협 본관(3층, 회의실)",서울특별시 영등포구 신길로 149(신길동),2193,1086,418,634,10,5,3,0,1,4,2,0,0,3,1080,6,1107
1582,Yeongdeunpo,투표소,SK4,신길제4동제1투,"서울우신초등학교(1층, 중관동 꿈샘터)",서울특별시 영등포구 신길로 190(신길동),2083,702,246,422,3,5,3,2,0,5,0,2,0,2,690,12,1381
1583,Yeongdeunpo,투표소,SK4,신길제4동제2투,"신길제4동주민센터(4층, 다목적강당)",서울특별시 영등포구 신길로42길 1(신길동),3186,1344,468,811,9,18,1,2,1,5,5,0,1,6,1327,17,1842
1584,Yeongdeunpo,투표소,SK4,신길제4동제3투,삼성래미안아파트 관리사무소(1층),"서울특별시 영등포구 가마산로79길 7(신길동, 삼성래미안아파트)",2114,1234,406,784,7,10,1,0,0,15,1,0,0,4,1228,6,880
1585,Yeongdeunpo,투표소,SK4,신길제4동제4투,"힐스테이트클래시안(103동 1층, 커뮤니티센터맘스카페)","서울특별시 영등포구 신길로28길 9(신길동, 힐스테이트 클래시안)",890,571,208,337,6,6,2,1,0,3,2,0,0,1,566,5,319
1586,Yeongdeunpo,투표소,SK5,신길제5동제1투,"구립신길5동 제2경로당(1층, 할머니방)",서울특별시 영등포구 도림로80길 6(신길동),1557,589,234,334,1,6,0,0,0,5,2,0,0,1,583,6,968
1587,Yeongdeunpo,투표소,SK5,신길제5동제2투,"영등포제1스포츠센터(1층, 다목적체육실)",서울특별시 영등포구 신풍로 1(신길동),2004,1041,335,668,4,13,1,0,0,9,1,0,0,2,1033,8,963
1588,Yeongdeunpo,투표소,SK5,신길제5동제3투,"대영초등학교(1층, 어울림실)",서울특별시 영등포구 신길로23길 43(신길동),2103,853,311,499,9,8,1,2,0,7,2,1,0,1,841,12,1250
1589,Yeongdeunpo,투표소,SK5,신길제5동제4투,"영등포종합사회복지관(3층, 사랑터)",서울특별시 영등포구 신길로13길 4(신길동),1842,736,272,439,5,8,0,1,0,2,2,1,0,1,731,5,1106
1590,Yeongdeunpo,투표소,SK6,신길제6동제1투,"대길초등학교 (1층, 도서실)",서울특별시 영등포구 대방천로 206(신길동),2235,769,286,446,2,12,0,1,0,4,6,1,0,3,761,8,1466
1591,Yeongdeunpo,투표소,SK6,신길제6동제2투,"영신고등학교 동관 (1층, 무용실)",서울특별시 영등포구 대방천로14길 18(신길동),2298,1186,380,763,6,9,0,3,0,8,1,1,0,3,1174,12,1112
1592,Yeongdeunpo,투표소,SK6,신길제6동제3투,"영신고등학교 (1층, 음악실)",서울특별시 영등포구 대방천로14길 18(신길동),2570,1280,411,829,4,13,2,4,0,5,3,0,2,2,1275,5,1290
1593,Yeongdeunpo,투표소,SK6,신길제6동제4투,"대길초등학교 본관(1층, 보건교육실)",서울특별시 영등포구 대방천로 206(신길동),3130,1251,486,699,10,15,3,7,0,11,4,1,1,4,1241,10,1879
1594,Yeongdeunpo,투표소,SK6,신길제6동제5투,"대길초등학교 (1층, 실과실)",서울특별시 영등포구 대방천로 206(신길동),2400,934,306,572,8,16,1,2,1,8,4,0,0,3,921,13,1466
1595,Yeongdeunpo,투표소,SK7,신길제7동제1투,"래미안에스티움아파트 생활지원센터(1층, 대회의실)","서울특별시 영등포구 신풍로 77(신길동, 래미안에스티움)",3089,1867,587,1219,4,15,3,2,0,11,3,1,0,6,1851,16,1222
1596,Yeongdeunpo,투표소,SK7,신길제7동제2투,"대방초등학교(1층, 구체육관)",서울특별시 영등포구 여의대방로35길 14(신길동),3536,1816,597,1135,11,19,2,6,1,17,0,1,3,9,1801,15,1720
1597,Yeongdeunpo,투표소,SK7,신길제7동제3투,"신길제7동주민센터(4층, 대회의실)",서울특별시 영등포구 여의대방로43길 10(신길동),3034,1209,382,775,8,15,1,3,0,9,1,0,0,3,1197,12,1825
1598,Yeongdeunpo,투표소,SK7,신길제7동제4투,삼환아파트 경로당(1층),"서울특별시 영등포구 여의대방로43라길 9(신길동, 삼환아파트)",2599,1485,413,1024,10,10,0,2,0,9,1,0,1,4,1474,11,1114
1599,Yeongdeunpo,투표소,DR1,대림제1동제1투,"영등포구보건소 분소(1층, 보건교육실)",서울특별시 영등포구 디지털로 441(대림동),2238,780,277,471,6,9,1,0,0,2,4,0,0,1,771,9,1458
1600,Yeongdeunpo,투표소,DR1,대림제1동제2투,"신대림초등학교(1층, 스마트교실)",서울특별시 영등포구 대림로8길 25(대림동),2274,856,320,510,5,7,1,0,0,5,3,0,0,4,855,1,1418
1601,Yeongdeunpo,투표소,DR1,대림제1동제3투,"e편한세상 영등포아델포레아파트(1층, 경로당)","서울특별시 영등포구 신길로 29(대림동, e편한세상 영등포 아델포레)",2173,1204,466,680,9,17,2,3,0,8,5,3,1,4,1198,6,969
1602,Yeongdeunpo,투표소,DR1,대림제1동제4투,"대림중학교(1층, 세미나실)",서울특별시 영등포구 시흥대로185길 6(대림동),2325,991,390,550,9,20,1,1,0,8,2,0,0,2,983,8,1334
1603,Yeongdeunpo,투표소,DR1,대림제1동제5투,"대림중학교(1층, 특수학습실)",서울특별시 영등포구 시흥대로185길 6(대림동),1695,525,202,304,2,2,1,2,0,4,2,1,1,1,522,3,1170
1604,Yeongdeunpo,투표소,DR2,대림제2동제1투,"대림2동주민센터(2층, 다목적회의실)",서울특별시 영등포구 대림로23길 25(대림동),1242,364,129,217,1,5,0,1,0,3,5,0,0,1,362,2,878
1605,Yeongdeunpo,투표소,DR2,대림제2동제2투,"대동초등학교 (1층, 재미있는 방)",서울특별시 영등포구 대림로21길 6(대림동),1543,495,194,275,5,7,2,0,1,4,1,0,0,1,490,5,1048
1606,Yeongdeunpo,투표소,DR2,대림제2동제3투,"영림초등학교 (1층, 유희실)",서울특별시 영등포구 시흥대로173길 14(대림동),3074,1150,463,642,4,14,3,0,1,8,2,0,0,2,1139,11,1924
1607,Yeongdeunpo,투표소,DR2,대림제2동제4투,"영림초등학교 (2층, 다온센터 회의실)",서울특별시 영등포구 시흥대로173길 14(대림동),3090,1198,496,649,5,18,1,3,0,11,4,0,0,6,1193,5,1892
1608,Yeongdeunpo,투표소,DR2,대림제2동제5투,"대동초등학교 (1층, 회의실)",서울특별시 영등포구 대림로21길 6(대림동),1797,564,210,320,2,8,3,1,0,6,2,0,0,3,555,9,1233
1609,Yeongdeunpo,투표소,DR3,대림제3동제1투,서남권글로벌센터(4층),서울특별시 영등포구 도신로 40서남권글로벌센터 (대림동),2691,1203,499,648,10,12,1,2,0,7,3,1,0,6,1189,14,1488
1610,Yeongdeunpo,투표소,DR3,대림제3동제2투,"도신초등학교(1층, 교직원회의실)",서울특별시 영등포구 도림로53길 32-9(대림동),2455,1002,438,515,8,9,0,2,0,9,6,1,0,4,992,10,1453
1611,Yeongdeunpo,투표소,DR3,대림제3동제3투,"도신초등학교(1층, 위클래스)",서울특별시 영등포구 도림로53길 32-9(대림동),2160,901,360,508,3,4,1,1,1,9,0,1,1,3,892,9,1259
1612,Yeongdeunpo,투표소,DR3,대림제3동제4투,"남부도로사업소(1층, 정비실)",서울특별시 영등포구 도림로 145(대림동),2032,693,303,368,4,8,0,0,0,2,2,0,1,1,689,4,1339
1613,Yeongdeunpo,투표소,DR3,대림제3동제5투,"영남중학교(2층, 강당)",서울특별시 영등포구 대림로31나길 17(대림동),2386,955,342,574,5,12,0,2,0,3,2,0,0,5,945,10,1431
1614,Yeongdeunpo,투표소,DR3,대림제3동제6투,"신영초등학교(1층, 연수실)",서울특별시 영등포구 도신로4길 32(대림동),2204,1075,437,585,6,19,0,5,0,8,5,0,0,4,1069,6,1129
1615,Yeongdeunpo,투표소,DR3,대림제3동제7투,"대림도서관(지하1층, 다목적실)",서울특별시 영등포구 도신로 27(대림동),2943,1580,528,993,12,19,3,0,0,13,2,0,0,4,1574,6,1363
1616,Dongjak,투표소,NRJ1,노량진제1동제1투,"우성(아)경로당(1층, 할머니방)",서울특별시 동작구 만양로8길 50(노량진동),2987,1701,587,1057,5,17,2,6,0,7,4,1,0,8,1694,7,1286
1617,Dongjak,투표소,NRJ1,노량진제1동제2투,"삼익상가(2층, 아동부 교육관)",서울특별시 동작구 만양로 84(노량진동),3387,1427,532,822,7,28,3,5,0,14,0,1,0,3,1415,12,1960
1618,Dongjak,투표소,NRJ1,노량진제1동제3투,"동작자원봉사센터(1층, 회의실)",서울특별시 동작구 만양로3길 14(노량진동),2144,1116,332,719,11,12,0,3,0,15,4,0,0,6,1102,14,1028
1619,Dongjak,투표소,NRJ1,노량진제1동제4투,"노량진1동 주민센터(2층, 주민자치회관)",서울특별시 동작구 장승배기로28길 30(노량진동),3647,1251,421,737,3,28,2,1,0,29,6,0,0,6,1233,18,2396
1620,Dongjak,투표소,NRJ1,노량진제1동제5투,"신동아리버파크(아)경로당(1층, 할머니방)",서울특별시 동작구 만양로 19(노량진동),2044,1041,380,618,5,14,2,1,2,4,1,0,2,5,1034,7,1003
1621,Dongjak,투표소,NRJ1,노량진제1동제6투,"본동초등학교(1층, 강당)",서울특별시 동작구 노량진로26길 16-40(본동),3127,1513,582,868,6,15,1,4,0,6,7,0,2,3,1494,19,1614
1622,Dongjak,투표소,NRJ1,노량진제1동제7투,래미안트윈파크(아) 경로당(1층),"서울특별시 동작구 노량진로23가길 23(본동, 래미안 트윈파크)",1692,1088,310,756,2,4,2,3,0,3,1,0,0,3,1084,4,604
1623,Dongjak,투표소,NRJ1,노량진제1동제8투,"영본초등학교(3층, 다목적강당)",서울특별시 동작구 만양로12가길 69(본동),3242,1754,579,1113,8,18,2,3,0,11,4,1,0,4,1743,11,1488
1624,Dongjak,투표소,NRJ2,노량진제2동제1투,"노량진초등학교(1층, 식당)",서울특별시 동작구 장승배기로 160(노량진동),1540,645,233,377,6,11,0,1,0,4,4,0,0,2,638,7,895
1625,Dongjak,투표소,NRJ2,노량진제2동제2투,"노량진2동주민센터(지하1층, 회의실)",서울특별시 동작구 장승배기로19길 48(노량진동),2681,1119,393,669,7,19,2,2,0,7,2,1,0,1,1103,16,1562
1626,Dongjak,투표소,NRJ2,노량진제2동제3투,연세주차장(1층),서울특별시 동작구 등용로4길 132(노량진동),2585,1094,379,669,3,12,1,2,1,8,2,0,0,2,1079,15,1491
1627,Dongjak,투표소,NRJ2,노량진제2동제4투,"동작구청 본관(5층, 대강당)",서울특별시 동작구 장승배기로 161(노량진동),2912,1121,393,653,14,22,1,4,0,17,1,0,0,5,1110,11,1791
1628,Dongjak,투표소,SD1,상도제1동제1투,"강남초등학교 체육관(1층, 강당)",서울특별시 동작구 강남초등길 15(상도1동),4518,2104,801,1183,11,26,2,13,0,17,7,0,3,10,2073,31,2414
1629,Dongjak,투표소,SD1,상도제1동제2투,"상도종합사회복지관(2층, 강당)",서울특별시 동작구 상도로39가길 7(상도1동),4542,1960,645,1203,13,23,2,11,0,19,8,1,0,10,1935,25,2582
1630,Dongjak,투표소,SD1,상도제1동제3투,"상도열린복지센터(2층, 활력충전실)",서울특별시 동작구 상도로38길 86(상도동),3494,1656,606,972,10,14,0,3,0,23,3,0,0,8,1639,17,1838
1631,Dongjak,투표소,SD1,상도제1동제4투,"상도SH빌(아)203동(지하1층, 주민사랑방)",서울특별시 동작구 상도로53길 70(상도동),3317,1591,533,976,8,23,1,2,1,17,6,0,0,4,1571,20,1726
1632,Dongjak,투표소,SD1,상도제1동제5투,"상도1동주민센터(3층, 문화강좌실)",서울특별시 동작구 상도로53길 9(상도동),3424,1638,433,1133,7,13,3,3,0,19,2,0,0,14,1627,11,1786
1633,Dongjak,투표소,SD1,상도제1동제6투,"상현중학교(1층, 체육관)",서울특별시 동작구 사당로2길 2-19(상도동),3344,1587,486,1031,11,16,4,3,1,10,6,0,2,5,1575,12,1757
1634,Dongjak,투표소,SD1,상도제1동제7투,"상현초등학교(1층, 다목적실)",서울특별시 동작구 상도로58길 21(상도동),3334,1400,520,793,13,19,5,9,0,10,9,0,1,7,1386,14,1934
1635,Dongjak,투표소,SD1,상도제1동제8투,"힐스테이트 상도센트럴파크(아)103동(1층, 커뮤니티센터)",서울특별시 동작구 상도로 346-1(상도동),3930,2285,743,1499,4,13,1,1,0,7,8,0,1,4,2281,4,1645
1636,Dongjak,투표소,SD2,상도제2동제1투,"동작청소년문화의집(지하1층, 소강당)",서울특별시 동작구 상도로15바길 5(상도동),4333,1970,662,1215,15,19,2,5,0,26,3,0,2,6,1955,15,2363
1637,Dongjak,투표소,SD2,상도제2동제2투,"상도2동주민센터(2층, 회의실)",서울특별시 동작구 상도로 211(상도동),4301,2007,573,1362,5,20,1,5,0,12,2,0,1,11,1992,15,2294
1638,Dongjak,투표소,SD2,상도제2동제3투,"장승중학교(1층, 다목적실)",서울특별시 동작구 장승배기로10가길 25(상도동),3355,1516,573,880,7,9,2,8,0,13,1,1,1,6,1501,15,1839
1639,Dongjak,투표소,SD2,상도제2동제4투,"신상도초등학교(1층, 과학1실)",서울특별시 동작구 장승배기로 14(상도동),3597,1835,560,1230,8,12,0,4,0,5,2,1,0,5,1827,8,1762
1640,Dongjak,투표소,SD2,상도제2동제5투,"장승중학교(1층, 협력종합예술활동연습실)",서울특별시 동작구 장승배기로10가길 25(상도동),2633,1077,399,622,11,17,1,4,0,6,3,0,0,5,1068,9,1556
1641,Dongjak,투표소,SD3,상도제3동제1투,"강현중학교(1층,체력단련실)",서울특별시 동작구 상도로13라길 22(상도동),4222,1880,764,1030,10,32,1,5,1,17,5,0,1,8,1874,6,2342
1642,Dongjak,투표소,SD3,상도제3동제2투,"상도3동주민센터(3층, 다목적실)",서울특별시 동작구 성대로2길 11(상도동),3322,1241,496,657,8,27,1,7,0,19,4,1,1,4,1225,16,2081
1643,Dongjak,투표소,SD3,상도제3동제3투,"상도3동주민센터(지하1층, 다목적실)",서울특별시 동작구 성대로2길 11(상도동),2876,1190,527,593,9,22,1,10,1,12,2,1,0,4,1182,8,1686
1644,Dongjak,투표소,SD3,상도제3동제4투,"구립 연꽃어린이집(1층, 유희실)",서울특별시 동작구 국사봉1길 235-1(상도동),2528,1080,496,526,5,21,0,3,1,8,1,0,0,4,1065,15,1448
1645,Dongjak,투표소,SD3,상도제3동제5투,"상도3동 청소년독서실(지하1층, 주차장)",서울특별시 동작구 국사봉2나길 25(상도동),4254,1865,784,992,14,21,2,1,0,14,7,1,1,12,1849,16,2389
1646,Dongjak,투표소,SD4,상도제4동제1투,"상도초등학교(1층, 다목적실)",서울특별시 동작구 성대로21길 62(상도동),2657,962,408,493,10,14,1,4,0,15,2,0,1,8,956,6,1695
1647,Dongjak,투표소,SD4,상도제4동제2투,"상도초등학교(2층, 강당)",서울특별시 동작구 성대로21길 62(상도동),3317,1243,524,641,6,29,2,4,0,7,7,1,3,3,1227,16,2074
1648,Dongjak,투표소,SD4,상도제4동제3투,"상도4동주민편의복합청사(동주민센터)(2층, 북카페)",서울특별시 동작구 양녕로27길 44(상도동),2467,1010,395,564,12,7,0,4,0,8,3,1,0,3,997,13,1457
1649,Dongjak,투표소,SD4,상도제4동제4투,"상도어울마당(지하1층, 다목적홀)",서울특별시 동작구 성대로 180(상도동),3388,1229,526,641,6,19,1,1,0,10,1,1,1,6,1213,16,2159
1650,Dongjak,투표소,SD4,상도제4동제5투,"상도4동주민편의복합청사(동주민센터)(3층, 다목적홀)",서울특별시 동작구 양녕로27길 44(상도동),4130,1831,705,1034,8,24,5,2,0,17,12,2,0,7,1816,15,2299
1651,Dongjak,투표소,SD4,상도제4동제6투,"삼성소리샘복지관(1층, 회의실)",서울특별시 동작구 양녕로30길 19-4(상도동),3582,1383,586,718,8,20,2,4,1,13,7,1,1,5,1366,17,2199
1652,Dongjak,투표소,HS,흑석동제1투,"흑석초등학교(1층, 돌봄교실3)",서울특별시 동작구 현충로 87(흑석동),2874,1553,307,1210,4,5,4,3,0,8,1,0,1,1,1544,9,1321
1653,Dongjak,투표소,HS,흑석동제2투,"흑석동주민센터(4층, 다목적강당)",서울특별시 동작구 흑석한강로 11(흑석동),2524,978,317,625,5,9,1,3,0,5,3,1,3,1,973,5,1546
1654,Dongjak,투표소,HS,흑석동제3투,"흑석 새마을금고(지하1층, 주차장)",서울특별시 동작구 서달로14길 32(흑석동),2912,1450,405,987,13,9,2,2,0,10,4,1,2,8,1443,7,1462
1655,Dongjak,투표소,HS,흑석동제4투,"흑석한강푸르지오(아) 103동(1층, 관리사무소앞 로비)","서울특별시 동작구 흑석한강로 27(흑석동, 흑석한강푸르지오)",2858,1499,364,1073,11,11,2,1,0,10,3,1,0,10,1486,13,1359
1656,Dongjak,투표소,HS,흑석동제5투,"중앙대학교 102관 약학대건물(지하1층, 창의작업실(Creative studio))",서울특별시 동작구 흑석로 84(흑석동),3196,1507,462,982,6,12,2,5,0,11,1,0,1,10,1492,15,1689
1657,Dongjak,투표소,HS,흑석동제6투,"중앙대부속중학교(1층, 강당)",서울특별시 동작구 서달로 124(흑석동),3457,1611,500,1047,11,14,2,1,0,13,6,1,1,7,1603,8,1846
1658,Dongjak,투표소,HS,흑석동제7투,"은로초등학교(1층, 식당)",서울특별시 동작구 서달로 115(흑석동),3076,1749,571,1118,5,14,3,2,0,12,4,0,0,6,1735,14,1327
1659,Dongjak,투표소,SD1,사당제1동제1투,"동작구치매안심센터(지하1층, 교육실)",서울특별시 동작구 남부순환로 2025동작구치매안심센터 (사당동),4525,2102,849,1129,18,23,5,8,0,10,14,0,1,14,2071,31,2423
1660,Dongjak,투표소,SD1,사당제1동제2투,베리타스휴게실(1층),서울특별시 동작구 남부순환로269길 48(사당동),3306,1542,657,779,11,32,5,4,0,20,6,2,1,7,1524,18,1764
1661,Dongjak,투표소,SD1,사당제1동제3투,"사당어르신종합복지관(1층, 로비)",서울특별시 동작구 남부순환로 2081(사당동),2969,1267,452,748,8,25,1,3,0,11,3,0,0,7,1258,9,1702
1662,Dongjak,투표소,SD1,사당제1동제4투,"남사초등학교(1층, 교직원회의실)",서울특별시 동작구 동작대로13길 22(사당동),2777,1161,498,600,8,14,3,3,0,12,9,0,0,4,1151,10,1616
1663,Dongjak,투표소,SD1,사당제1동제5투,"사당1동주민센터(3층, 문화의방)",서울특별시 동작구 동작대로17길 28(사당동),3444,1394,487,837,7,22,2,2,0,10,5,2,2,7,1383,11,2050
1664,Dongjak,투표소,SD2,사당제2동제1투,"이수힐스테이트(아) 경로당(1층, 경로당)","서울특별시 동작구 동작대로39길 22(동작동, 이수힐스테이트)",3239,1873,561,1253,11,17,1,3,0,7,2,0,0,6,1861,12,1366
1665,Dongjak,투표소,SD2,사당제2동제2투,"경문고등학교(1층, 대강당(운화관))",서울특별시 동작구 동작대로 171(동작동),2194,842,329,469,5,12,2,1,0,8,0,1,0,3,830,12,1352
1666,Dongjak,투표소,SD2,사당제2동제3투,"사당유니드(아)(지하2층, 입주자대표회의실)",서울특별시 동작구 동작대로29길 195(사당동),2209,1032,446,535,6,14,3,0,0,10,0,0,0,10,1024,8,1177
1667,Dongjak,투표소,SD2,사당제2동제4투,"사당2동주민센터(3층, 다목적회의실)",서울특별시 동작구 동작대로29길 52(사당동),3142,1335,347,930,6,18,0,3,0,14,2,1,1,7,1329,6,1807
1668,Dongjak,투표소,SD2,사당제2동제5투,"동작여성인력개발센터(2층, 민원실)",서울특별시 동작구 사당로 299(사당동),2068,918,313,568,4,12,0,3,0,6,1,0,0,5,912,6,1150
1669,Dongjak,투표소,SD2,사당제2동제6투,"사당새마을금고 사당2동지점(지하1층, 대강당)",서울특별시 동작구 동작대로29길 115우성상가3단지 지하 101호 (사당동),2401,1312,353,910,4,11,1,5,0,7,1,0,0,4,1296,16,1089
1670,Dongjak,투표소,SD2,사당제2동제7투,"사당우성(아)3단지(1층, 관리사무소)",서울특별시 동작구 동작대로29길 115(사당동),2282,1343,353,945,1,18,1,0,0,11,1,0,0,5,1335,8,939
1671,Dongjak,투표소,SD3,사당제3동제1투,"사당중학교(1층, 무용실)",서울특별시 동작구 사당로9가길 58(사당동),3033,1332,481,801,13,6,1,3,0,8,4,1,0,7,1325,7,1701
1672,Dongjak,투표소,SD3,사당제3동제2투,"남성초등학교(1층, 축구부실)",서울특별시 동작구 사당로23길 57-14(사당동),1344,574,188,361,3,5,2,1,0,6,1,0,0,1,568,6,770
1673,Dongjak,투표소,SD3,사당제3동제3투,"사당3동주민센터(2층, 다목적회의실)",서울특별시 동작구 사당로17길 86(사당동),2323,1181,340,812,3,5,1,3,1,5,2,0,1,5,1178,3,1142
1674,Dongjak,투표소,SD3,사당제3동제4투,"삼일초등학교(2층, 체육관)",서울특별시 동작구 사당로23나길 27(사당동),4045,1909,692,1150,9,16,2,2,0,13,4,1,0,5,1894,15,2136
1675,Dongjak,투표소,SD3,사당제3동제5투,구립 삼익경로당(1층),서울특별시 동작구 사당로27길 190(사당동),2578,1524,568,898,12,13,1,7,0,11,3,0,0,3,1516,8,1054
1676,Dongjak,투표소,SD3,사당제3동제6투,"동작삼성래미안(아)105동(지하1층, 대강당)",서울특별시 동작구 사당로23바길 9(사당동),2622,1607,497,1055,7,15,2,1,0,10,2,0,1,8,1598,9,1015
1677,Dongjak,투표소,SD4,사당제4동제1투,"진흥아파트 경로당(1층, 회의실)",서울특별시 동작구 사당로16아길 43(사당동),2414,1079,443,580,4,18,2,3,0,9,2,1,1,5,1068,11,1335
1678,Dongjak,투표소,SD4,사당제4동제2투,"사당4동주민센터(2층, 회의실)",서울특별시 동작구 사당로16아길 6(사당동),2168,1036,366,625,3,11,3,1,1,7,4,1,0,6,1028,8,1132
1679,Dongjak,투표소,SD4,사당제4동제3투,"남성중학교 별관(1층, 예절실)",서울특별시 동작구 남부순환로269길 166(사당동),2866,1238,514,660,6,24,1,5,1,18,1,0,0,2,1232,6,1628
1680,Dongjak,투표소,SD4,사당제4동제4투,"사당종합사회복지관(4층, 대강당)",서울특별시 동작구 사당로14길 20(사당동),2179,952,374,517,10,16,1,2,0,14,3,0,2,2,941,11,1227
1681,Dongjak,투표소,SD5,사당제5동제1투,"상도중학교 어울림관(1층, 탁구실)",서울특별시 동작구 사당로2가길 72(사당동),2305,1108,358,706,3,17,2,6,0,5,1,0,0,2,1100,8,1197
1682,Dongjak,투표소,SD5,사당제5동제2투,"신남성초등학교 체육관(1층, 어울림터)",서울특별시 동작구 사당로 146(사당동),2508,1226,456,720,7,16,3,5,0,8,2,0,0,4,1221,5,1282
1683,Dongjak,투표소,SD5,사당제5동제3투,"사당5동주민센터(3층, 다목적회의실)",서울특별시 동작구 사당로2가길 219(사당동),2484,1029,396,575,4,17,1,3,0,16,2,0,0,9,1023,6,1455
1684,Dongjak,투표소,SD5,사당제5동제4투,"사당솔밭도서관(1층, 로비)",서울특별시 동작구 솔밭로 86(사당동),2096,983,414,524,10,7,1,7,0,9,1,0,0,2,975,8,1113
1685,Dongjak,투표소,DB,대방동제1투,"영화초등학교(1층, 본관동 중앙홀)",서울특별시 동작구 등용로8길 3(대방동),2869,1278,495,717,13,8,1,3,0,16,5,0,1,9,1268,10,1591
1686,Dongjak,투표소,DB,대방동제2투,"영화초등학교(1층, 본관동 중앙홀)",서울특별시 동작구 등용로8길 3(대방동),2936,1451,487,912,11,7,1,3,0,8,6,0,0,7,1442,9,1485
1687,Dongjak,투표소,DB,대방동제3투,"신길초등학교(1층, 강당)",서울특별시 동작구 알마타길 16(대방동),3602,1806,642,1079,10,22,2,5,0,23,4,1,1,9,1798,8,1796
1688,Dongjak,투표소,DB,대방동제4투,"대방종합사회복지관(1층, 경로식당)",서울특별시 동작구 여의대방로44길 47(대방동),2780,1416,624,735,6,14,2,2,0,8,5,0,0,9,1405,11,1364
1689,Dongjak,투표소,DB,대방동제5투,"대방동주민센터(지하1층, 누리마루)",서울특별시 동작구 여의대방로44길 20(대방동),2898,1585,502,1029,8,15,2,2,0,14,0,1,0,7,1580,5,1313
1690,Dongjak,투표소,DB,대방동제6투,"강남중학교(2층, 강당)",서울특별시 동작구 대방동15길 29(대방동),2571,1166,453,645,5,24,1,2,1,10,9,1,0,4,1155,11,1405
1691,Dongjak,투표소,DB,대방동제7투,"대림초등학교(1층, 1-3반)",서울특별시 동작구 대방동1길 22(대방동),3761,1536,610,825,15,10,2,12,0,25,4,0,1,6,1510,26,2225
1692,Dongjak,투표소,DB,대방동제8투,"성남고등학교(1층, 1-1반)",서울특별시 동작구 대방동길 74(대방동),3558,1416,580,760,6,13,1,4,0,18,5,1,1,6,1395,21,2142
1693,Dongjak,투표소,SDB1,신대방제1동제1투,"문창초등학교(1층, 초록파랑돌봄교실)",서울특별시 동작구 신대방2길 14(신대방동),2096,795,295,456,1,14,0,2,0,10,2,3,0,3,786,9,1301
1694,Dongjak,투표소,SDB1,신대방제1동제2투,"신대방1동주민센터(3층, 다목적회의실)",서울특별시 동작구 신대방길 72(신대방동),2474,1015,396,580,5,13,0,2,0,9,4,1,0,0,1010,5,1459
1695,Dongjak,투표소,SDB1,신대방제1동제3투,"대방중학교(1층, 보건교육실)",서울특별시 동작구 여의대방로10길 24(신대방동),3602,2010,800,1138,12,8,7,4,0,13,7,0,0,7,1996,14,1592
1696,Dongjak,투표소,SDB1,신대방제1동제4투,현진에버빌(아) 경로당(1층),서울특별시 동작구 신대방1나길 45(신대방동),4180,1695,600,1020,4,21,1,4,0,10,8,2,0,8,1678,17,2485
1697,Dongjak,투표소,SDB1,신대방제1동제5투,"신대방우성(아)경로당(1층, 할아버지방)",서울특별시 동작구 여의대방로 22(신대방동),3512,2133,682,1398,8,11,0,3,0,13,1,0,0,5,2121,12,1379
1698,Dongjak,투표소,SDB2,신대방제2동제1투,"문창중학교(1층, 보건실)",서울특별시 동작구 여의대방로22나길 40(신대방동),2683,1234,470,726,4,9,2,2,0,6,1,0,0,5,1225,9,1449
1699,Dongjak,투표소,SDB2,신대방제2동제2투,"신대방2동주민센터(1층, 주민공유공간)",서울특별시 동작구 여의대방로24길 76(신대방동),2962,1272,504,685,16,20,1,7,0,22,0,1,1,5,1262,10,1690
1700,Dongjak,투표소,SDB2,신대방제2동제3투,"보라매e편한세상(아)정문옆101동(1층, 문고)",서울특별시 동작구 보라매로 70(신대방동),4068,1770,702,957,25,26,5,4,0,25,8,0,1,7,1760,10,2298
1701,Dongjak,투표소,SDB2,신대방제2동제4투,"동작구민회관(1층, 강당)",서울특별시 동작구 보라매로5길 28(신대방동),3545,1859,534,1261,5,19,4,3,0,13,4,1,0,5,1849,10,1686
1702,Gwanak,투표소,BRM,보라매동제1투,"시립관악노인종합복지관(1층, 식당)",서울특별시 관악구 보라매로 35(봉천동),3259,1711,628,1019,4,22,2,2,0,14,8,1,1,2,1703,8,1548
1703,Gwanak,투표소,BRM,보라매동제2투,"당곡중학교(1층, 시청각실)",서울특별시 관악구 봉천로13길 101(봉천동),3154,1355,596,690,7,16,4,5,0,10,8,1,0,6,1343,12,1799
1704,Gwanak,투표소,BRM,보라매동제3투,"당곡초등학교(3층, 강당)",서울특별시 관악구 보라매로2길 23(봉천동),4054,1745,681,954,6,22,6,8,2,19,11,3,3,11,1726,19,2309
1705,Gwanak,투표소,BRM,보라매동제4투,"보라매동주민센터(2층, 강의실)",서울특별시 관악구 봉천로 279-8(봉천동),3701,1287,584,623,6,24,0,2,0,13,12,1,0,4,1269,18,2414
1706,Gwanak,투표소,BRM,보라매동제5투,"동명아동복지센터(1층, 주차장)",서울특별시 관악구 봉천로23라길 15(봉천동),3676,1495,681,736,10,26,3,3,0,13,4,0,1,7,1484,11,2181
1707,Gwanak,투표소,ECH,은천동제1투,"은천동주민센터(지하1층, 다목적실)",서울특별시 관악구 봉천로33나길 30(봉천동),3384,1333,507,754,13,11,0,1,1,16,3,1,0,11,1318,15,2051
1708,Gwanak,투표소,ECH,은천동제2투,"두산아파트 1단지 상가(3층, 305호 낙성대라이온스클럽)",서울특별시 관악구 봉천로 391(봉천동),3563,1499,574,823,7,25,4,8,0,25,9,2,0,9,1486,13,2064
1709,Gwanak,투표소,ECH,은천동제3투,"은천동주민센터(3층, 대강당)",서울특별시 관악구 봉천로33나길 30(봉천동),2974,1332,527,744,8,14,1,3,0,10,10,1,0,6,1324,8,1642
1710,Gwanak,투표소,ECH,은천동제4투,"벽산블루밍아파트제1관리사무소(지하1층, 블루밍도서관)","서울특별시 관악구 은천로 93(봉천동, 벽산블루밍아파트)",2988,1776,771,942,5,22,1,2,0,4,7,2,0,8,1764,12,1212
1711,Gwanak,투표소,ECH,은천동제5투,"벽산블루밍아파트제2관리사무소(2층, 다목적강당)",서울특별시 관악구 양녕로 117(봉천동),3010,1590,738,803,11,14,2,3,1,6,1,0,1,5,1585,5,1420
1712,Gwanak,투표소,ECH,은천동제6투,"서울관광고등학교(1층, 음악실)",서울특별시 관악구 은천로15길 25(봉천동),3348,1281,577,648,8,18,1,0,0,5,8,0,1,7,1273,8,2067
1713,Gwanak,투표소,ECH,은천동제7투,"은천초등학교(2층, 강당)",서울특별시 관악구 은천로 69(봉천동),3561,1372,629,664,10,27,5,4,0,9,9,0,0,5,1362,10,2189
1714,Gwanak,투표소,SH,성현동제1투,"성현동자치회관(지하1층, 주차장)",서울특별시 관악구 관악로 255-7(봉천동),3006,1562,733,772,7,17,1,1,0,6,8,1,0,6,1552,10,1444
1715,Gwanak,투표소,SH,성현동제2투,"동부센트레빌아파트 105동(1층, 공부방)",서울특별시 관악구 은천로33길 5(봉천동),4029,1834,793,956,5,25,1,5,0,16,8,0,1,9,1819,15,2195
1716,Gwanak,투표소,SH,성현동제3투,"성현동아아파트 경로당(1층, 107동 앞)",서울특별시 관악구 관악로 285(봉천동),2607,1638,642,938,7,13,2,2,0,13,3,0,0,8,1628,10,969
1717,Gwanak,투표소,SH,성현동제4투,"관악드림타운아파트 1단지 경로당(1층, 118동 앞)",서울특별시 관악구 성현로 80(봉천동),2893,1612,583,967,7,16,2,6,2,7,9,0,2,5,1606,6,1281
1718,Gwanak,투표소,SH,성현동제5투,"성현동주민센터(3층, 다목적실)",서울특별시 관악구 구암길 38(봉천동),2852,1419,567,792,6,15,0,5,0,15,4,0,0,1,1405,14,1433
1719,Gwanak,투표소,SH,성현동제6투,"구암초등학교(1층, 4-5반)",서울특별시 관악구 구암길 1(봉천동),1526,630,269,339,3,2,1,5,0,4,2,0,0,2,627,3,896
1720,Gwanak,투표소,SH,성현동제7투,"관악드림타운아파트 2단지 경로당(1층, 147동 앞)",서울특별시 관악구 구암길 106(봉천동),2956,1458,642,763,4,12,4,1,0,8,6,1,1,5,1447,11,1498
1721,Gwanak,투표소,JA,중앙동제1투,"중앙동주민센터(지하1층, 새싹작은도서관)",서울특별시 관악구 양녕로6다길 7(봉천동),3597,1279,498,669,13,21,3,8,0,32,7,4,1,9,1265,14,2318
1722,Gwanak,투표소,JA,중앙동제2투,"신봉초등학교(2층, 대강당)",서울특별시 관악구 양녕로6나길 1(봉천동),3404,1432,617,714,13,25,1,6,0,23,9,2,2,9,1421,11,1972
1723,Gwanak,투표소,JA,중앙동제3투,"중앙동주민센터(2층, 대강당)",서울특별시 관악구 양녕로6다길 7(봉천동),4293,1463,575,778,20,19,5,2,0,24,8,2,0,17,1450,13,2830
1724,Gwanak,투표소,CHR,청림동제1투,"청림동주민센터(1층, 주차장)",서울특별시 관악구 관악로40길 39(봉천동),2892,1654,538,1048,10,15,4,1,0,9,5,0,1,7,1638,16,1238
1725,Gwanak,투표소,CHR,청림동제2투,"서울YWCA봉천종합사회복지관(2층, 강당)",서울특별시 관악구 관악로 254(봉천동),3404,1435,605,767,11,14,2,7,0,4,3,2,0,7,1422,13,1969
1726,Gwanak,투표소,CHR,청림동제3투,"관악푸르지오아파트 경로당(1층, 122동 뒤 관리사무소)",서울특별시 관악구 관악로30길 27(봉천동),3665,2209,895,1230,9,13,5,4,0,12,8,0,1,7,2184,25,1456
1727,Gwanak,투표소,HW,행운동제1투,"서울미술고등학교(1층, 강당)",서울특별시 관악구 남부순환로247길 26(봉천동),3494,1474,567,788,20,19,8,8,0,22,12,0,0,14,1458,16,2020
1728,Gwanak,투표소,HW,행운동제2투,"로즈빌(1층, 주차장)",서울특별시 관악구 솔밭로 21(봉천동),3922,1748,630,992,12,20,4,8,0,32,14,0,1,10,1723,25,2174
1729,Gwanak,투표소,HW,행운동제3투,"관악중학교(1층, 체육관)",서울특별시 관악구 남부순환로237길 60(봉천동),4062,1649,702,825,11,29,4,12,1,26,9,1,2,12,1634,15,2413
1730,Gwanak,투표소,HW,행운동제4투,"행운동주민센터(3층, 다목적실)",서울특별시 관악구 행운1길 43(봉천동),3716,1355,532,706,13,24,6,8,0,25,6,2,1,9,1332,23,2361
1731,Gwanak,투표소,HW,행운동제5투,"봉천초등학교(신관 지하1층, 로비)",서울특별시 관악구 행운1라길 17(봉천동),2646,1022,447,512,6,20,1,2,1,11,6,0,1,5,1012,10,1624
1732,Gwanak,투표소,HW,행운동제6투,"관악우성아파트 경로당(1층, 103동 뒤 관리사무소 할머니방)","서울특별시 관악구 관악로30길 12(봉천동, 관악우성아파트)",3480,2005,801,1120,8,26,4,12,0,12,3,1,1,8,1996,9,1475
1733,Gwanak,투표소,CHRY,청룡동제1투,"봉림중학교(1층, 무용실)",서울특별시 관악구 장군봉길 72(봉천동),4303,1482,594,757,9,31,3,8,0,25,11,0,0,8,1446,36,2821
1734,Gwanak,투표소,CHRY,청룡동제2투,"관악초등학교(1층, 과학실)",서울특별시 관악구 청룡4길 49(봉천동),4607,1843,724,954,21,29,2,9,0,45,11,3,2,12,1812,31,2764
1735,Gwanak,투표소,CHRY,청룡동제3투,"관악중앙새마을금고 본점(7층, 대강당)",서울특별시 관악구 청룡1길 2(봉천동),4380,1714,612,911,24,23,9,10,1,36,11,4,2,25,1668,46,2666
1736,Gwanak,투표소,CHRY,청룡동제4투,"풍림아이원아파트 102동(1층, 주차장)",서울특별시 관악구 청룡길 78(봉천동),4138,1996,840,1015,13,32,6,4,0,20,6,1,2,21,1960,36,2142
1737,Gwanak,투표소,CHRY,청룡동제5투,"관악구의회(1층, 로비)",서울특별시 관악구 관악로 145(봉천동),5219,2280,821,1271,22,22,6,7,0,47,17,0,1,29,2243,37,2939
1738,Gwanak,투표소,CHRY,청룡동제6투,"청룡동주민센터(지하1층, 주차장)",서울특별시 관악구 쑥고개로 44(봉천동),3755,1687,633,985,10,16,4,1,0,15,3,0,1,11,1679,8,2068
1739,Gwanak,투표소,NSD,낙성대동제1투,"싱글벙글교육센터(싱글동 1층, 다목적강당)",서울특별시 관악구 남부순환로234길 73(봉천동),4527,1628,600,884,23,17,10,4,0,31,11,1,1,11,1593,35,2899
1740,Gwanak,투표소,NSD,낙성대동제2투,"낙성대동주민센터(5층, 다목적실)",서울특별시 관악구 낙성대로4가길 5(봉천동),3610,1388,527,753,19,19,7,4,0,19,6,1,0,13,1368,20,2222
1741,Gwanak,투표소,NSD,낙성대동제3투,"서울인헌초등학교(1층, 교무협의실)",서울특별시 관악구 낙성대로 23(봉천동),3803,1615,558,928,15,22,9,9,0,26,13,1,0,24,1605,10,2188
1742,Gwanak,투표소,IH,인헌동제1투,"인헌중학교(1층, 다목적실)",서울특별시 관악구 인헌9길 35(봉천동),3281,1099,410,608,3,11,5,6,0,20,8,0,5,7,1083,16,2182
1743,Gwanak,투표소,IH,인헌동제2투,"인헌동주민센터(3층, 대강당)",서울특별시 관악구 남부순환로246가길 20(봉천동),4044,1536,578,857,12,18,3,6,0,20,7,0,0,10,1511,25,2508
1744,Gwanak,투표소,IH,인헌동제3투,"인헌중학교(1층, 무용실)",서울특별시 관악구 인헌9길 35(봉천동),3624,1473,558,797,23,33,2,10,0,15,7,2,0,10,1457,16,2151
1745,Gwanak,투표소,IH,인헌동제4투,"인헌고등학교 정보관(1층, 현관로비)",서울특별시 관악구 인헌9길 74(봉천동),3456,1372,533,752,8,24,2,2,0,16,8,1,0,13,1359,13,2084
1746,Gwanak,투표소,IH,인헌동제5투,"반석푸른숲아파트(지하1층, 주차장)",서울특별시 관악구 인헌16다길 14(봉천동),3536,1901,844,947,17,21,2,7,1,16,10,0,1,12,1878,23,1635
1747,Gwanak,투표소,NH,남현동제1투,"사당초등학교(1층, 체육관)",서울특별시 관악구 남현4길 51(남현동),3167,1465,568,835,9,10,3,1,0,16,3,0,1,6,1452,13,1702
1748,Gwanak,투표소,NH,남현동제2투,"사당초등학교(1층, 체육관)",서울특별시 관악구 남현4길 51(남현동),2896,1371,512,790,6,13,4,4,0,15,4,0,1,9,1358,13,1525
1749,Gwanak,투표소,NH,남현동제3투,"남현동주민센터(지하1층, 주차장)",서울특별시 관악구 남현1가길 29(남현동),3265,1317,455,768,13,21,3,9,0,15,7,2,1,9,1303,14,1948
1750,Gwanak,투표소,NH,남현동제4투,"남현동주민센터(4층, 다목적실)",서울특별시 관악구 남현1가길 29(남현동),3168,1289,461,761,8,20,2,1,0,15,4,1,0,7,1280,9,1879
1751,Gwanak,투표소,SIR,신림동제1투,"에드원빌딩(지하1층, 위드)","서울특별시 관악구 남부순환로191길 7(신림동, 에드원)",5268,1411,517,757,17,33,12,6,0,26,9,0,0,12,1389,22,3857
1752,Gwanak,투표소,SIR,신림동제2투,"신림동주민센터(2층, 회의실)",서울특별시 관악구 신림동길 14(신림동),5287,1337,512,693,24,38,6,7,0,13,11,1,1,9,1315,22,3950
1753,Gwanak,투표소,SIR,신림동제3투,"신림동주민센터(3층, 다목적실)",서울특별시 관악구 신림동길 14(신림동),3687,1029,392,541,12,19,3,6,0,21,15,0,0,5,1014,15,2658
1754,Gwanak,투표소,SIR,신림동제4투,"새들경로당(1층, 쉼터)",서울특별시 관악구 관천로20길 43(신림동),3304,1256,503,655,7,23,6,4,0,16,11,2,0,10,1237,19,2048
1755,Gwanak,투표소,SS,신사동제1투,"신림우방아파트(1층, 경로당)","서울특별시 관악구 관천로27길 2(신림동, 우방아파트)",3140,1257,502,668,10,25,3,10,0,13,4,3,0,4,1242,15,1883
1756,Gwanak,투표소,SS,신사동제2투,"구립신사경로당(1층, 할머니방)",서울특별시 관악구 조원로 151-1(신림동),3786,1242,493,642,14,20,1,6,0,28,7,1,1,6,1219,23,2544
1757,Gwanak,투표소,SS,신사동제3투,"신사동주민센터 임시청사(5층, 회의실)",서울특별시 관악구 남부순환로 1517-1(신림동),3440,1148,446,619,6,18,4,6,0,26,5,1,2,5,1138,10,2292
1758,Gwanak,투표소,SS,신사동제4투,"남부초등학교 복합관(2층, 어울채 실습실)",서울특별시 관악구 남부순환로163길 14(신림동),3289,1045,409,563,4,25,1,4,0,19,7,2,0,3,1037,8,2244
1759,Gwanak,투표소,SS,신사동제5투,"남부초등학교 복합관(2층, 어울채 학년활동실)",서울특별시 관악구 남부순환로163길 14(신림동),3836,1366,536,736,9,27,6,3,0,17,10,1,0,4,1349,17,2470
1760,Gwanak,투표소,JW,조원동제1투,"조원동주민센터(지하2층, 다목적실)",서울특별시 관악구 조원로12길 25(신림동),3843,1306,491,712,17,24,1,4,0,14,6,1,1,9,1280,26,2537
1761,Gwanak,투표소,JW,조원동제2투,"조원동주민센터(2층, 회의실)",서울특별시 관악구 조원로12길 25(신림동),3743,1352,522,746,7,27,4,8,0,10,3,0,2,5,1334,18,2391
1762,Gwanak,투표소,JW,조원동제3투,"관악농협(6층, 강당)",서울특별시 관악구 남부순환로 1369(신림동),3397,1258,481,692,3,22,3,5,0,18,5,0,0,8,1237,21,2139
1763,Gwanak,투표소,JW,조원동제4투,"조원초등학교(1층, 대강의실)",서울특별시 관악구 조원로 67(신림동),2099,909,314,547,5,13,1,1,0,10,2,0,0,5,898,11,1190
1764,Gwanak,투표소,MS,미성동제1투,"미성동자치회관(1층, 강의실)",서울특별시 관악구 난곡로52길 16(신림동),3690,1191,477,631,10,12,3,4,0,19,4,1,0,3,1164,27,2499
1765,Gwanak,투표소,MS,미성동제2투,"미성초등학교(1층, 제3과학실)",서울특별시 관악구 문성로 79(신림동),3189,1386,527,800,7,18,2,3,0,10,4,0,1,4,1376,10,1803
1766,Gwanak,투표소,MS,미성동제3투,"신림푸르지오아파트 관리동(지하1층, 입주자대표회의실)","서울특별시 관악구 남부순환로 1430(신림동, 신림푸르지오아파트)",3226,2045,669,1315,6,16,1,5,0,12,2,0,1,2,2029,16,1181
1767,Gwanak,투표소,MS,미성동제4투,"난우초등학교 본관(1층, 회의실)",서울특별시 관악구 난우길 40(신림동),3122,1283,515,701,5,23,0,5,0,18,5,0,0,5,1277,6,1839
1768,Gwanak,투표소,MS,미성동제5투,"난우초등학교 본관(3층, 체육관)",서울특별시 관악구 난우길 40(신림동),3042,1259,521,690,7,14,2,2,0,6,4,1,1,3,1251,8,1783
1769,Gwanak,투표소,MS,미성동제6투,"미성동주민센터(2층, 회의실)",서울특별시 관악구 난곡로 249(신림동),3048,1283,509,718,11,13,0,4,0,8,1,0,1,5,1270,13,1765
1770,Gwanak,투표소,MS,미성동제7투,"구립약수경로당(1층, 할머니방)",서울특별시 관악구 미성길 123(신림동),2912,1473,644,771,4,25,2,7,0,9,4,0,1,2,1469,4,1439
1771,Gwanak,투표소,NK,난곡동제1투,"난곡동주민센터(2층, 다목적실)",서울특별시 관악구 난곡로30길 40(신림동),3473,1213,538,619,4,25,5,3,0,6,2,0,0,1,1203,10,2260
1772,Gwanak,투표소,NK,난곡동제2투,"난곡새마을금고(5층, 회의실)",서울특별시 관악구 난곡로 210(신림동),3847,1498,625,788,10,24,5,4,0,17,4,0,0,9,1486,12,2349
1773,Gwanak,투표소,NK,난곡동제3투,보명사 부설주차장(1층),서울특별시 관악구 법원단지9길 91(신림동),3699,1769,818,859,12,31,0,5,0,9,9,0,0,7,1750,19,1930
1774,Gwanak,투표소,NK,난곡동제4투,"난곡초등학교(2층, 다목적강당)",서울특별시 관악구 난곡로35길 102(신림동),2833,1072,414,618,2,9,0,7,0,6,3,1,0,3,1063,9,1761
1775,Gwanak,투표소,NK,난곡동제5투,"난곡보건분소(4층, 보건교육실)",서울특별시 관악구 난곡로 162(신림동),2758,1194,476,676,4,17,2,3,0,3,3,0,0,3,1187,7,1564
1776,Gwanak,투표소,NK,난곡동제6투,"난우중학교(1층, 아름드리관)",서울특별시 관악구 난곡로16길 32(신림동),3124,1168,486,624,9,19,4,0,0,11,3,4,0,4,1164,4,1956
1777,Gwanak,투표소,NHY,난향동제1투,"난향동주민센터(5층, 다목적실)",서울특별시 관악구 난곡로 67(신림동),2861,1264,532,690,3,13,1,2,0,5,6,0,0,5,1257,7,1597
1778,Gwanak,투표소,NHY,난향동제2투,"관악산휴먼시아아파트 관리동(2층, 다목적실)",서울특별시 관악구 난곡로 55(신림동),3624,1853,731,1058,8,25,3,3,0,9,5,1,2,4,1849,4,1771
1779,Gwanak,투표소,NHY,난향동제3투,"신림종합사회복지관(3층, 대강당)",서울특별시 관악구 난곡로 110(신림동),3323,1315,577,672,9,19,1,5,1,9,1,0,1,5,1300,15,2008
1780,Gwanak,투표소,SW,서원동제1투,"로마아파트(지하1층, 주차장)",서울특별시 관악구 남부순환로194길 7(신림동),3799,1586,625,846,20,20,3,7,2,20,10,1,0,12,1566,20,2213
1781,Gwanak,투표소,SW,서원동제2투,"서원동주민센터(2층, 창작실)",서울특별시 관악구 신림로 282(신림동),3243,1068,405,582,9,22,1,5,0,16,6,0,1,6,1053,15,2175
1782,Gwanak,투표소,SW,서원동제3투,"서원동주민센터(지하1층, 주차장)",서울특별시 관악구 신림로 282(신림동),3963,1166,444,605,18,26,7,7,0,21,7,1,1,7,1144,22,2797
1783,Gwanak,투표소,SW,서원동제4투,"신림건영4차아파트(지하1층, 주차장)",서울특별시 관악구 신림로48길 17-20(신림동),2949,1019,424,522,8,17,4,5,0,13,5,0,0,3,1001,18,1930
1784,Gwanak,투표소,SW,서원동제5투,"서원경로당(1층, 할아버지방)",서울특별시 관악구 서원3길 10(신림동),3387,1305,546,690,11,14,1,3,0,13,3,1,0,9,1291,14,2082
1785,Gwanak,투표소,SIW,신원동제1투,"신원경로당(1층, 할머니방)",서울특별시 관악구 남부순환로170길 6(신림동),3903,1334,515,713,19,32,5,6,0,15,9,0,0,7,1321,13,2569
1786,Gwanak,투표소,SIW,신원동제2투,"신일경로당(1층, 할머니방)",서울특별시 관악구 문성로32길 18(신림동),2874,1080,385,617,12,16,4,7,0,14,5,0,1,7,1068,12,1794
1787,Gwanak,투표소,SIW,신원동제3투,"신원동주민센터(4층, 다목적실)",서울특별시 관악구 신원로3길 13(신림동),3122,1099,453,558,10,26,4,3,0,16,7,1,1,8,1087,12,2023
1788,Gwanak,투표소,SIW,신원동제4투,"신림초등학교(1층, 해오름실)",서울특별시 관악구 문성로28길 31(신림동),3259,1115,479,571,9,25,5,3,0,7,6,0,1,1,1107,8,2144
1789,Gwanak,투표소,SR,서림동제1투,"베리타스오피스텔(1층, 주차장)",서울특별시 관악구 신림로 196(신림동),3690,1448,577,770,9,28,6,5,0,12,11,0,1,10,1429,19,2242
1790,Gwanak,투표소,SR,서림동제2투,"신림현대아파트 104동(지하1층, 주차장)",서울특별시 관악구 신림로29길 8(신림동),2945,1796,625,1094,9,20,0,3,0,18,6,1,0,7,1783,13,1149
1791,Gwanak,투표소,SR,서림동제3투,"신성초등학교(1층, 상담실)",서울특별시 관악구 신림로 114(신림동),3401,1157,428,648,17,17,8,0,0,9,2,1,1,8,1139,18,2244
1792,Gwanak,투표소,SR,서림동제4투,"다보(1층, 주차장)",서울특별시 관악구 서림3길 24(신림동),4159,1435,531,780,12,29,5,12,0,20,7,0,1,19,1416,19,2724
1793,Gwanak,투표소,SR,서림동제5투,"지전연립-제일성도교회 건너편(1층, 주차장)",서울특별시 관악구 복은길 85(신림동),3516,1566,695,759,11,36,9,5,1,15,6,1,1,9,1548,18,1950
1794,Gwanak,투표소,SAS,삼성동제1투,행복나무 마을활력소(1층),서울특별시 관악구 신림로 143(신림동),2408,872,341,489,7,9,4,6,0,2,2,1,0,1,862,10,1536
1795,Gwanak,투표소,SAS,삼성동제2투,원신공영주차장(1층),서울특별시 관악구 양지길 63(신림동),2882,1351,570,710,7,26,2,8,0,10,3,1,2,6,1345,6,1531
1796,Gwanak,투표소,SAS,삼성동제3투,"성민종합사회복지관(지하1층, 강당)",서울특별시 관악구 호암로 549(신림동),3177,1434,570,803,7,13,1,6,0,12,3,0,1,9,1425,9,1743
1797,Gwanak,투표소,SAS,삼성동제4투,"신우초등학교(1층, 체육관)",서울특별시 관악구 호암로 498(신림동),1878,850,328,489,4,10,1,3,0,4,1,1,1,4,846,4,1028
1798,Gwanak,투표소,SAS,삼성동제5투,"관악도시농업센터(1층, 다목적실)",서울특별시 관악구 광신길 142(신림동),2562,1239,589,609,10,9,1,2,0,5,4,0,0,4,1233,6,1323
1799,Gwanak,투표소,SAS,삼성동제6투,"삼성산주공아파트(1층, 경로당)",서울특별시 관악구 호암로 399(신림동),3106,1746,679,1003,10,22,2,2,0,11,5,0,1,7,1742,4,1360
1800,Gwanak,투표소,DH,대학동제1투,"대학동주민센터(지하1층, 옥내주차장)",서울특별시 관악구 신림로 111(신림동),4963,1593,506,943,15,31,9,12,1,25,9,2,0,15,1568,25,3370
1801,Gwanak,투표소,DH,대학동제2투,"삼성초등학교 체육관(2층, 강당)",서울특별시 관악구 대학7길 52(신림동),3367,1614,566,949,14,18,4,5,0,14,11,0,0,18,1599,15,1753
1802,Gwanak,투표소,DH,대학동제3투,"금호타운아파트(지하1층, 옥내주차장)","서울특별시 관악구 대학18길 9(신림동, 금호타운1차아파트)",4481,1769,763,901,11,31,7,9,0,9,10,1,1,11,1754,15,2712
1803,Gwanak,투표소,DH,대학동제4투,"관악청소년회관(지하1층, 옥내주차장)",서울특별시 관악구 신림로23길 17(신림동),4396,1572,517,921,21,34,4,3,0,23,11,0,1,9,1544,28,2824
1804,Seocho,투표소,SCH1,서초1동제1투,"서일초등학교 (1층, 도서실)",서울특별시 서초구 남부순환로339길 38(서초동),4064,2052,469,1514,6,22,7,1,1,11,5,0,3,6,2045,7,2012
1805,Seocho,투표소,SCH1,서초1동제2투,"서초1동주민센터 (3층, 대회의실)",서울특별시 서초구 사임당로 89(서초동),3292,1651,396,1201,8,13,2,2,0,9,6,0,0,5,1642,9,1641
1806,Seocho,투표소,SCH1,서초1동제3투,"서초구립중앙노인종합복지관 (2층, 소강당)",서울특별시 서초구 서초대로54길 45(서초동),3320,1697,354,1301,5,11,1,4,0,6,1,1,0,7,1691,6,1623
1807,Seocho,투표소,SCH1,서초1동제4투,"서울교육대학교 부설초등학교 (1층, 음악실)",서울특별시 서초구 서초중앙로 96(서초동),2968,1393,349,999,5,11,1,6,0,7,5,1,1,1,1386,7,1575
1808,Seocho,투표소,SCH2,서초2동제1투,"서초2동주민센터 (4층, 대강당)",서울특별시 서초구 서초대로70길 51(서초동),3725,2145,343,1745,7,19,4,2,0,12,3,0,1,1,2137,8,1580
1809,Seocho,투표소,SCH2,서초2동제2투,"서이초등학교 (1층, 다목적실)",서울특별시 서초구 서운로 35(서초동),3634,1374,376,953,4,9,0,3,0,10,4,1,1,6,1367,7,2260
1810,Seocho,투표소,SCH2,서초2동제3투,"서울시교육연수지원센터 (1층, 대강당)",서울특별시 서초구 남부순환로347길 69(서초동),3456,1785,425,1304,5,16,0,3,0,13,2,1,0,9,1778,7,1671
1811,Seocho,투표소,SCH2,서초2동제4투,"서운중학교(1층, 중앙현관)",서울특별시 서초구 서운로 115(서초동),3188,1710,298,1369,4,11,0,2,0,14,1,1,0,6,1706,4,1478
1812,Seocho,투표소,SCH3,서초3동제1투,"서초3동주민센터(3층, 다목적실)",서울특별시 서초구 반포대로 34(서초동),4048,1971,364,1559,4,15,1,2,0,6,2,0,0,3,1956,15,2077
1813,Seocho,투표소,SCH3,서초3동제2투,"신중초등학교 (1층, 다목적실)",서울특별시 서초구 남부순환로317길 15(서초동),2816,1416,372,994,4,13,1,3,0,14,1,0,0,8,1410,6,1400
1814,Seocho,투표소,SCH3,서초3동제3투,"서울고등학교 (1층, 강당)",서울특별시 서초구 효령로 197(서초동),2834,1520,327,1148,7,11,1,2,0,8,1,1,1,4,1511,9,1314
1815,Seocho,투표소,SCH3,서초3동제4투,"서초고등학교 (1층, 물리지학실험실)",서울특별시 서초구 반포대로27길 29(서초동),2683,1367,317,1004,9,10,3,3,0,6,1,0,0,7,1360,7,1316
1816,Seocho,투표소,SCH3,서초3동제5투,"지방공기업평가원(1층, 1강의실)",서울특별시 서초구 반포대로30길 12-6(서초동),3161,1513,404,1055,8,8,1,4,0,15,3,0,0,6,1504,9,1648
1817,Seocho,투표소,SCH3,서초3동제6투,"서초중학교 (1층, 가사실)",서울특별시 서초구 반포대로13길 48(서초동),3966,1886,463,1352,8,14,6,2,0,13,1,0,1,11,1871,15,2080
1818,Seocho,투표소,SCH3,서초3동제7투,"상문고등학교 지혜관 (1층, 보건교실)",서울특별시 서초구 명달로 45(방배동),2443,1394,241,1118,5,7,0,2,0,7,2,1,1,4,1388,6,1049
1819,Seocho,투표소,SCH4,서초4동제1투,"서초초등학교 (1층, 6-1반)",서울특별시 서초구 서운로 178(서초동),3812,1608,254,1314,5,7,3,2,0,6,1,0,1,10,1603,5,2204
1820,Seocho,투표소,SCH4,서초4동제2투,"서일중학교 (1층, 회의실)",서울특별시 서초구 서운로21길 2(서초동),3327,2009,303,1664,8,7,3,3,0,7,1,1,0,3,2000,9,1318
1821,Seocho,투표소,SCH4,서초4동제3투,"원명초등학교 (1층, 1-3반)",서울특별시 서초구 고무래로 90-6(서초동),3072,1923,236,1646,5,8,2,3,0,6,2,0,0,11,1919,4,1149
1822,Seocho,투표소,SCH4,서초4동제4투,"원명초등학교 (1층, 1-4반)",서울특별시 서초구 고무래로 90-6(서초동),2733,1819,184,1596,8,7,2,1,0,7,2,0,1,2,1810,9,914
1823,Seocho,투표소,SCH4,서초4동제5투,장안마을 경로당 (1층),서울특별시 서초구 서초대로55길 13(서초동),3535,2167,347,1777,8,4,2,6,0,7,2,0,0,7,2160,7,1368
1824,Seocho,투표소,SCH4,서초4동제6투,서초래미안아파트 경로당 (1층),"서울특별시 서초구 서초대로65길 13-10(서초동, 서초래미안아파트)",2848,1942,337,1559,10,7,3,5,0,6,2,2,0,0,1931,11,906
1825,Seocho,투표소,JW,잠원동제1투,"잠원동주민센터 (5층, 대강당)",서울특별시 서초구 나루터로 38(잠원동),3385,1636,280,1316,6,6,2,4,0,11,0,1,0,5,1631,5,1749
1826,Seocho,투표소,JW,잠원동제2투,"신동중학교 (1층, 사회교실)",서울특별시 서초구 나루터로 27(잠원동),2576,1405,196,1174,5,5,1,3,0,9,2,0,0,3,1398,7,1171
1827,Seocho,투표소,JW,잠원동제3투,"신동초등학교(1층, 1-4반)",서울특별시 서초구 나루터로 15(잠원동),2592,1541,300,1207,8,8,3,2,0,3,1,1,0,4,1537,4,1051
1828,Seocho,투표소,JW,잠원동제4투,"서초여성가족플라자(1층, 로비)",서울특별시 서초구 잠원로8길 38(잠원동),3283,1927,269,1604,8,15,3,2,0,11,1,0,0,8,1921,6,1356
1829,Seocho,투표소,JW,잠원동제5투,대우아이빌아파트 주차장 (1층),서울특별시 서초구 신반포로45길 23(잠원동),2764,1274,350,869,8,18,3,2,0,5,4,1,0,3,1263,11,1490
1830,Seocho,투표소,JW,잠원동제6투,한강아파트 경로당 (1층),"서울특별시 서초구 잠원로 213-10(잠원동, 한강아파트)",2987,1793,264,1497,5,7,1,2,1,7,1,0,1,1,1787,6,1194
1831,Seocho,투표소,BPB,반포본동제1투,"세화고등학교 (1층, 1-3반)",서울특별시 서초구 신반포로 56-7(반포동),1935,980,225,736,8,3,1,0,0,5,0,0,0,0,978,2,955
1832,Seocho,투표소,BPB,반포본동제2투,"반포아파트 복지문화센터 (1층, 경로당)",서울특별시 서초구 신반포로 9(반포동),1738,1216,189,1002,4,7,2,0,0,7,0,0,0,2,1213,3,522
1833,Seocho,투표소,BPB,반포본동제3투,"반포아파트 관리사무소 (1층, 당직실)",서울특별시 서초구 신반포로 45(반포동),1915,1200,183,995,3,7,0,0,0,4,0,0,0,3,1195,5,715
1834,Seocho,투표소,BPB,반포본동제4투,"반포초등학교 (1층, 과학실1)",서울특별시 서초구 신반포로 55-4(반포동),1279,789,154,618,3,5,0,0,0,1,0,0,0,2,783,6,490
1835,Seocho,투표소,BP1,반포1동제1투,반포리체 아파트 경로당(1층),서울특별시 서초구 고무래로 35(반포동),2348,1538,246,1263,3,8,1,1,0,7,2,0,0,2,1533,5,810
1836,Seocho,투표소,BP1,반포1동제2투,"반포자이아파트 자이안센터(1층, 연회장)","서울특별시 서초구 신반포로 270(반포동, 반포자이아파트)",3449,2066,389,1636,9,10,1,2,0,6,0,0,0,5,2058,8,1383
1837,Seocho,투표소,BP1,반포1동제3투,"서초구립반포1동어린이집 (1층,주차장)",서울특별시 서초구 신반포로 318(반포동),3151,1162,352,759,6,13,1,1,0,10,4,0,0,6,1152,10,1989
1838,Seocho,투표소,BP1,반포1동제4투,"고도일병원 제2별관 (1층, 직원식당)",서울특별시 서초구 사평대로57길 81(반포동),3073,1088,359,676,4,15,1,2,0,7,3,0,0,5,1072,16,1985
1839,Seocho,투표소,BP1,반포1동제5투,"반포1동 주민센터(5층, 대강당)",서울특별시 서초구 사평대로 273(반포동),2761,707,243,429,4,10,0,6,0,4,3,0,0,3,702,5,2054
1840,Seocho,투표소,BP1,반포1동제6투,"서울원촌초등학교 (1층, 한울림방)",서울특별시 서초구 사평대로45길 26(반포동),3368,1805,219,1558,6,8,0,0,0,5,1,0,0,4,1801,4,1563
1841,Seocho,투표소,BP1,반포1동제7투,"서울서원초등학교(1층, 한울림방)",서울특별시 서초구 고무래로 63(반포동),2832,1742,273,1437,6,3,0,0,0,8,3,0,1,7,1738,4,1090
1842,Seocho,투표소,BP2,반포2동제1투,"신반포상가 (지하1층, 교육관A)",서울특별시 서초구 신반포로15길 29(반포동),3293,1960,223,1714,0,3,0,4,0,6,1,0,0,3,1954,6,1333
1843,Seocho,투표소,BP2,반포2동제2투,"잠원초등학교 (1층, 1-4반)",서울특별시 서초구 신반포로16길 15-25(반포동),2895,1858,278,1541,7,5,1,4,0,7,4,0,0,8,1855,3,1037
1844,Seocho,투표소,BP2,반포2동제3투,"래미안퍼스티지 (지하2층, 대연회장)","서울특별시 서초구 반포대로 275(반포동, 래미안퍼스티지아파트)",2769,1904,192,1684,6,10,2,0,0,5,1,0,0,0,1900,4,865
1845,Seocho,투표소,BP3,반포3동제1투,"반포3동 주민센터(1층, 갤러리)",서울특별시 서초구 신반포로23길 78(잠원동),3366,1766,245,1501,3,3,0,0,0,8,0,0,0,1,1761,5,1600
1846,Seocho,투표소,BP3,반포3동제2투,"반원초등학교 (1층, 대강당 <가>)",서울특별시 서초구 잠원로3길 28(잠원동),2023,1203,198,982,8,2,0,2,0,3,3,0,0,2,1200,3,820
1847,Seocho,투표소,BP3,반포3동제3투,"한신시티21오피스텔 (1층, 휴게실)",서울특별시 서초구 반포대로 316(잠원동),2296,1515,222,1268,4,4,0,5,0,6,1,0,0,2,1512,3,781
1848,Seocho,투표소,BP3,반포3동제4투,"반원초등학교 (1층, 대강당 <나>)",서울특별시 서초구 잠원로3길 28(잠원동),2519,1483,195,1265,5,5,1,0,0,4,1,0,0,2,1478,5,1036
1849,Seocho,투표소,BP3,반포3동제5투,"경원중학교 (1층, 협력종합연습실)",서울특별시 서초구 신반포로33길 39(잠원동),3321,1988,323,1627,5,8,1,2,0,10,2,0,0,2,1980,8,1333
1850,Seocho,투표소,BP4,반포4동제1투,"방배중학교 (1층, 다목적실)",서울특별시 서초구 동광로 144(반포동),2559,1235,277,928,4,12,0,3,0,2,3,0,0,3,1232,3,1324
1851,Seocho,투표소,BP4,반포4동제2투,"반포4동주민센터 (3층, 다목적실)",서울특별시 서초구 사평대로28길 70(반포동),2885,1398,301,1061,3,12,0,0,0,6,3,0,0,7,1393,5,1487
1852,Seocho,투표소,BP4,반포4동제3투,반포미도1차아파트 부녀회관 (1층),서울특별시 서초구 서초중앙로29길 28(반포동),2765,1899,336,1538,1,5,0,4,0,3,0,0,1,3,1891,8,866
1853,Seocho,투표소,BP4,반포4동제4투,"반도빌딩 (1층, 세미나실)",서울특별시 서초구 고무래로10길 26(반포동),1862,1120,222,870,3,6,1,2,0,3,0,1,1,2,1111,9,742
1854,Seocho,투표소,BP4,반포4동제5투,"반포4동주민센터 (4층, 서래홀)",서울특별시 서초구 사평대로28길 70(반포동),2126,1146,205,905,5,6,2,2,0,5,3,1,0,5,1139,7,980
1855,Seocho,투표소,BBB,방배본동제1투,"방배본동주민센터 (3층, 강당)",서울특별시 서초구 동광로19길 38(방배동),2999,1593,326,1219,7,13,0,1,1,7,1,0,1,9,1585,8,1406
1856,Seocho,투표소,BBB,방배본동제2투,"서래초등학교 (3층, 체육관)",서울특별시 서초구 방배로 260(방배동),3035,1747,231,1485,8,3,1,2,0,6,1,0,0,3,1740,7,1288
1857,Seocho,투표소,BBB,방배본동제3투,롯데캐슬헤론아파트 주민집회소 (1층),서울특별시 서초구 동광로1길 112(방배동),3821,2021,494,1479,6,11,0,2,1,8,3,0,0,2,2006,15,1800
1858,Seocho,투표소,BBB,방배본동제4투,방배아이파크아파트 관리사무소 (1층),서울특별시 서초구 동광로3길 18(방배동),3163,1676,526,1097,5,15,0,7,0,12,2,1,0,5,1670,6,1487
1859,Seocho,투표소,BB1,방배1동제1투,"방배1동주민센터 (3층, 대강당)",서울특별시 서초구 효령로29길 43(방배동),2843,1308,418,834,8,10,1,5,1,8,4,0,0,7,1296,12,1535
1860,Seocho,투표소,BB1,방배1동제2투,방배1동 제2자치회관 (1층),서울특별시 서초구 방배로23길 31-6(방배동),3452,1702,496,1132,6,21,4,8,0,15,2,1,2,5,1692,10,1750
1861,Seocho,투표소,BB1,방배1동제3투,"방일초등학교 자람관(1층, 체육관 <가>)",서울특별시 서초구 방배로18길 52(방배동),2447,1254,345,859,3,17,3,2,0,7,3,0,1,6,1246,8,1193
1862,Seocho,투표소,BB1,방배1동제4투,"방일초등학교 자람관(1층, 체육관 <나>)",서울특별시 서초구 방배로18길 52(방배동),2533,1536,240,1261,4,6,6,1,0,7,1,0,0,7,1533,3,997
1863,Seocho,투표소,BB2,방배2동제1투,"방배2동주민센터 (3층, 강당)",서울특별시 서초구 청두곶길 36(방배동),2604,1201,358,801,4,20,0,0,0,6,2,0,0,4,1195,6,1403
1864,Seocho,투표소,BB2,방배2동제2투,"이수초등학교 (1층, 다목적실)",서울특별시 서초구 방배천로4길 23(방배동),1446,715,214,468,1,14,1,4,0,3,2,0,0,5,712,3,731
1865,Seocho,투표소,BB2,방배2동제3투,"이수중학교 (1층, 학생식당)",서울특별시 서초구 방배중앙로3길 32(방배동),1394,684,201,458,4,4,0,3,0,6,0,1,0,5,682,2,710
1866,Seocho,투표소,BB2,방배2동제4투,"방배롯데캐슬아르떼 아파트(1층, 북카페로비)","서울특별시 서초구 방배천로18길 11(방배동, 방배롯데캐슬아르떼)",2762,1668,445,1147,11,21,2,4,0,20,0,1,0,9,1660,8,1094
1867,Seocho,투표소,BB2,방배2동제5투,"이수초등학교(1층, 늘봄터)",서울특별시 서초구 방배천로4길 23(방배동),2242,1048,320,675,8,11,1,1,0,12,3,1,0,8,1040,8,1194
1868,Seocho,투표소,BB2,방배2동제6투,방배우성아파트 경로당(1층),"서울특별시 서초구 방배선행길 1(방배동, 방배우성아파트)",1906,1305,324,955,2,5,0,4,1,5,0,1,0,3,1300,5,601
1869,Seocho,투표소,BB2,방배2동제7투,남태령 마을회관(1층),서울특별시 서초구 전원말안길 2(방배동),1203,738,230,484,4,7,1,0,0,2,3,0,0,4,735,3,465
1870,Seocho,투표소,BB3,방배3동제1투,"방배3동주민센터 (7층, 강당)",서울특별시 서초구 방배로 40(방배동),2848,1724,271,1421,4,8,0,0,0,8,2,1,0,5,1720,4,1124
1871,Seocho,투표소,BB3,방배3동제2투,"방배아트자이아파트 104동 자이안센터 (1층, 로비)","서울특별시 서초구 명달로9길 57(방배동, 방배아트자이)",2679,1649,312,1292,3,11,0,2,0,10,2,1,1,5,1639,10,1030
1872,Seocho,투표소,BB3,방배3동제3투,"방배유스센터 (4층, 강당)",서울특별시 서초구 방배로5길 11(방배동),1617,772,140,603,6,7,1,4,0,5,0,0,0,1,767,5,845
1873,Seocho,투표소,BB3,방배3동제4투,"방현초등학교 (1층, 방현글로벌리더관 <가>)",서울특별시 서초구 효령로4길 58(방배동),1700,848,292,521,2,11,2,2,0,9,1,0,0,2,842,6,852
1874,Seocho,투표소,BB3,방배3동제5투,"방현초등학교 (1층, 방현글로벌리더관 <나>)",서울특별시 서초구 효령로4길 58(방배동),2856,1426,394,987,10,10,1,1,0,10,2,0,0,3,1418,8,1430
1875,Seocho,투표소,BB3,방배3동제6투,"백석예술대학교 교육동 (1층, 로비)",서울특별시 서초구 효령로 114(방배동),1636,901,268,602,8,6,0,1,0,3,4,0,0,3,895,6,735
1876,Seocho,투표소,BB4,방배4동제1투,"방배4동주민센터(1층, 커피숍)",서울특별시 서초구 방배로 173(방배동),2893,1516,263,1222,2,6,1,0,0,10,1,0,0,4,1509,7,1377
1877,Seocho,투표소,BB4,방배4동제2투,"반포세무서 (지하1층, 신고서자기작성교실)",서울특별시 서초구 방배로 163(방배동),2617,1368,326,989,8,16,1,1,0,12,1,0,1,5,1360,8,1249
1878,Seocho,투표소,BB4,방배4동제3투,"방배4동 주민센터(4층, 대강당)",서울특별시 서초구 방배로 173(방배동),2334,1002,300,669,5,10,0,1,0,7,1,0,0,0,993,9,1332
1879,Seocho,투표소,BB4,방배4동제4투,"방배초등학교 가온누리터(1층, 보건교육실)",서울특별시 서초구 방배중앙로13길 26(방배동),3100,1531,530,930,8,22,5,6,0,13,3,0,0,5,1522,9,1569
1880,Seocho,투표소,BB4,방배4동제5투,"서초구보훈회관 (지하1층, 강당)",서울특별시 서초구 방배로27길 13(방배동),1343,600,199,384,5,4,0,1,0,2,0,0,0,3,598,2,743
1881,Seocho,투표소,BB4,방배4동제6투,"서문여자중학교 (1층, 제1과학실)",서울특별시 서초구 동광로12길 84(방배동),2842,1778,441,1291,9,10,1,3,0,9,3,0,0,7,1774,4,1064
1882,Seocho,투표소,YJ1,양재1동제1투,"구립양재종합사회복지관 (2층, 소강당)",서울특별시 서초구 남부순환로 2610(양재동),2596,1297,412,829,6,17,1,4,0,12,2,1,0,4,1288,9,1299
1883,Seocho,투표소,YJ1,양재1동제2투,"남서울농협본점 (4층, 강당)",서울특별시 서초구 바우뫼로 195(양재동),3071,1603,558,984,7,19,3,5,0,8,2,0,0,6,1592,11,1468
1884,Seocho,투표소,YJ1,양재1동제3투,"양재내곡교육지원센터 (1층, 3D프린터실)",서울특별시 서초구 강남대로 190(양재동),2548,1256,342,869,6,14,3,3,0,10,0,0,0,2,1249,7,1292
1885,Seocho,투표소,YJ1,양재1동제4투,"양재초등학교 (3층, 다목적교실)",서울특별시 서초구 바우뫼로18길 14(양재동),2770,1587,418,1126,6,7,2,5,0,7,1,0,0,3,1575,12,1183
1886,Seocho,투표소,YJ1,양재1동제5투,"우면초등학교 (1층, 로비)",서울특별시 서초구 태봉로 59(우면동),3469,1822,662,1095,5,22,3,3,0,12,2,0,0,6,1810,12,1647
1887,Seocho,투표소,YJ1,양재1동제6투,"양재1동주민센터 (3층, 주민사랑방)",서울특별시 서초구 바우뫼로 41(우면동),2797,1340,443,846,10,18,4,0,0,2,2,1,0,3,1329,11,1457
1888,Seocho,투표소,YJ1,양재1동제7투,"우암초등학교 (1층, 다목적교실)",서울특별시 서초구 바우뫼로7길 38(우면동),2528,1356,300,1022,6,13,0,2,0,2,1,0,0,5,1351,5,1172
1889,Seocho,투표소,YJ1,양재1동제8투,"영동중학교 (1층, 교직원식당)",서울특별시 서초구 성촌길 14(우면동),3017,1668,617,995,4,22,0,4,0,9,5,0,1,4,1661,7,1349
1890,Seocho,투표소,YJ1,양재1동제9투,"우솔초등학교 (1층, 로비)",서울특별시 서초구 양재대로2길 74(우면동),3664,2110,616,1442,4,15,1,7,0,11,0,0,0,1,2097,13,1554
1891,Seocho,투표소,YJ1,양재1동제10투,"LH서초5단지 아파트 주민공동시설(1층, GX실)",서울특별시 서초구 양재대로2길 11(우면동),2908,1636,729,863,8,14,1,4,0,3,3,0,0,5,1630,6,1272
1892,Seocho,투표소,YJ2,양재2동제1투,"양재2동 주민센터(4층, 강당)",서울특별시 서초구 강남대로12길 44(양재동),2960,1211,421,752,1,8,5,2,0,9,0,0,0,6,1204,7,1749
1893,Seocho,투표소,YJ2,양재2동제2투,"서울매헌초등학교(4층, 체육관)",서울특별시 서초구 언남길 8(양재동),2626,1193,421,707,13,15,1,7,0,11,4,1,0,6,1186,7,1433
1894,Seocho,투표소,YJ2,양재2동제3투,"영동농협 (3층, 강당)",서울특별시 서초구 동산로6길 3(양재동),3400,1601,554,979,8,21,2,3,0,14,6,1,0,3,1591,10,1799
1895,Seocho,투표소,YJ2,양재2동제4투,"언남중학교 (1층, 음악실)",서울특별시 서초구 동산로 55(양재동),3307,1518,537,910,13,24,1,4,0,11,3,0,1,6,1510,8,1789
1896,Seocho,투표소,YJ2,양재2동제5투,"언남고등학교(1층, 음악실)",서울특별시 서초구 동산로13길 35(양재동),3065,1305,447,794,9,25,1,1,0,8,2,3,0,5,1295,10,1760
1897,Seocho,투표소,NK,내곡동제1투,"내곡느티나무쉼터(1층,로비)",서울특별시 서초구 염곡말길 9(염곡동),1563,652,141,486,2,7,1,2,0,3,0,0,0,4,646,6,911
1898,Seocho,투표소,NK,내곡동제2투,"언남초등학교 (1층, 본관로비 <가>)",서울특별시 서초구 헌릉로8길 42(내곡동),2615,1427,390,990,7,13,3,4,0,6,2,0,0,8,1423,4,1188
1899,Seocho,투표소,NK,내곡동제3투,"언남초등학교 (1층, 본관로비 <나>)",서울특별시 서초구 헌릉로8길 42(내곡동),3233,1673,538,1084,7,15,3,2,0,9,1,0,1,4,1664,9,1560
1900,Seocho,투표소,NK,내곡동제4투,"내곡열린문화센터(내곡동주민센터 1층, 로비)",서울특별시 서초구 청계산로15길 77(신원동),3271,1573,509,1022,4,7,2,1,0,7,6,1,1,2,1562,11,1698
1901,Gangnam,투표소,SIS,신사동제1투,"신구초등학교 복합화시설 (4층, 다목적실)",서울특별시 강남구 압구정로18길 28(신사동),2313,1052,205,827,1,8,1,1,0,4,0,1,0,2,1050,2,1261
1902,Gangnam,투표소,SIS,신사동제2투,"신사동주민센터(4층, 회의실)",서울특별시 강남구 압구정로 128(신사동),1740,733,220,492,3,10,0,2,0,5,0,0,0,1,733,0,1007
1903,Gangnam,투표소,SIS,신사동제3투,"구립신사어린이집(지하1층, 주차장)",서울특별시 강남구 도산대로15길 26(신사동),1896,813,261,508,6,8,0,3,1,14,2,0,0,6,809,4,1083
1904,Gangnam,투표소,SIS,신사동제4투,"현대고등학교(1층, 다목적실)",서울특별시 강남구 압구정로 127(압구정동),2812,1736,112,1611,0,2,1,2,0,2,0,1,0,1,1732,4,1076
1905,Gangnam,투표소,SIS,신사동제5투,"신사중학교(1층, 학생식당)",서울특별시 강남구 압구정로 123(압구정동),2494,1671,151,1495,4,5,1,1,0,3,0,0,0,5,1665,6,823
1906,Gangnam,투표소,NH1,논현1동제1투,"논현1동주민센터(2층, 회의실)",서울특별시 강남구 학동로20길 25(논현동),3614,972,304,627,5,9,2,3,1,10,1,0,0,3,965,7,2642
1907,Gangnam,투표소,NH1,논현1동제2투,"논현초등학교 복합화시설(3층, 체육관 <가>)",서울특별시 강남구 강남대로120길 33(논현동),3515,1252,352,849,4,10,2,3,1,10,2,1,1,5,1240,12,2263
1908,Gangnam,투표소,NH1,논현1동제3투,"국민연금공단 서울남부지역본부(지하1층, 회의실)",서울특별시 강남구 도산대로 128(논현동),3840,1566,381,1129,10,9,4,2,0,9,2,1,0,8,1555,11,2274
1909,Gangnam,투표소,NH1,논현1동제4투,"논현초등학교 복합화시설(3층, 체육관 <나>)",서울특별시 강남구 강남대로120길 33(논현동),3887,1194,374,766,6,17,4,5,0,6,5,0,0,3,1186,8,2693
1910,Gangnam,투표소,NH1,논현1동제5투,세심정데이케어센터(지하1층),서울특별시 강남구 논현로115길 35-1(논현동),3383,1146,354,740,6,14,1,2,0,11,1,0,0,3,1132,14,2237
1911,Gangnam,투표소,NH2,논현2동제1투,"논현2동주민센터(1층, 회의실)",서울특별시 강남구 학동로43길 17(논현동),3812,1470,290,1145,3,10,3,2,0,10,1,1,0,2,1467,3,2342
1912,Gangnam,투표소,NH2,논현2동제2투,"논현2동주민센터(2층, 로비)",서울특별시 강남구 학동로43길 17(논현동),2563,1195,219,930,4,11,2,2,0,7,0,3,0,7,1185,10,1368
1913,Gangnam,투표소,NH2,논현2동제3투,"언북중학교(1층, 동아리실)",서울특별시 강남구 도산대로38길 27(논현동),2000,869,233,608,3,9,1,0,0,6,2,0,0,1,863,6,1131
1914,Gangnam,투표소,NH2,논현2동제4투,"학동초등학교(1층, 실과실)",서울특별시 강남구 선릉로115길 42(논현동),3948,1863,394,1414,9,14,2,2,0,14,1,0,2,2,1854,9,2085
1915,Gangnam,투표소,NH2,논현2동제5투,"컨벤션헤리츠(2층, 로비)",서울특별시 강남구 논현로 662(논현동),3756,1313,355,927,8,10,0,1,0,4,2,0,1,0,1308,5,2443
1916,Gangnam,투표소,AKJ,압구정동제1투,"압구정고등학교(1층, 교과교실1)",서울특별시 강남구 압구정로39길 20(압구정동),3195,1815,100,1700,1,5,1,0,0,4,0,0,0,1,1812,3,1380
1917,Gangnam,투표소,AKJ,압구정동제2투,동호경로당(1층),"서울특별시 강남구 압구정로29길 57(압구정동, 현대아파트)",2155,1382,115,1250,5,3,0,2,0,2,0,0,0,3,1380,2,773
1918,Gangnam,투표소,AKJ,압구정동제3투,"압구정초등학교(1층, 소강당)",서울특별시 강남구 압구정로39길 29(압구정동),2523,1661,121,1522,3,6,2,2,0,3,0,0,0,1,1660,1,862
1919,Gangnam,투표소,AKJ,압구정동제4투,"신구중학교(1층, 체육실)",서울특별시 강남구 압구정로36길 17(신사동),2443,1244,216,993,5,7,1,1,0,11,1,1,0,2,1238,6,1199
1920,Gangnam,투표소,AKJ,압구정동제5투,한양경로당(1층),"서울특별시 강남구 압구정로 313(압구정동, 한양아파트)",3190,2046,194,1819,2,12,0,2,0,9,1,1,0,2,2042,4,1144
1921,Gangnam,투표소,AKJ,압구정동제6투,"청담고등학교(1층, 무용실)",서울특별시 강남구 압구정로 419(압구정동),3012,1806,162,1616,4,6,0,2,0,4,0,0,0,5,1799,7,1206
1922,Gangnam,투표소,AKJ,압구정동제7투,"압구정 평생학습관(3층, 강당)",서울특별시 강남구 언주로172길 26(신사동),1387,726,113,603,4,2,0,0,0,2,0,0,0,0,724,2,661
1923,Gangnam,투표소,CHD,청담동제1투,"청담동주민센터(6층, 강당)",서울특별시 강남구 압구정로79길 26(청담동),3498,1608,228,1354,4,5,2,1,0,1,3,0,1,4,1603,5,1890
1924,Gangnam,투표소,CHD,청담동제2투,"청담초등학교 해솔관(2층, 다목적체육관)",서울특별시 강남구 압구정로71길 9(청담동),2583,1326,135,1173,6,2,1,1,0,3,0,0,2,1,1324,2,1257
1925,Gangnam,투표소,CHD,청담동제3투,"강남청소년수련관(2층, 체력단련실)",서울특별시 강남구 영동대로131길 26(청담동),2408,1401,190,1192,3,6,1,2,0,3,0,0,1,1,1399,2,1007
1926,Gangnam,투표소,CHD,청담동제4투,"강남청소년수련관(지하1층, 아름드리방)",서울특별시 강남구 영동대로131길 26(청담동),1944,905,110,777,1,8,0,0,0,3,1,1,0,1,902,3,1039
1927,Gangnam,투표소,CHD,청담동제5투,"청담평생학습관(지하1층, 건강교실)",서울특별시 강남구 학동로67길 11(청담동),3186,1667,318,1309,3,14,1,0,0,5,3,0,1,7,1661,6,1519
1928,Gangnam,투표소,CHD,청담동제6투,"언북초등학교 후관(1층, 과학실1)",서울특별시 강남구 삼성로135길 42(청담동),3158,1517,345,1125,6,10,0,8,0,9,2,1,1,5,1512,5,1641
1929,Gangnam,투표소,CHD,청담동제7투,청담경로당(1층),서울특별시 강남구 도산대로67길 15(청담동),1934,847,154,670,2,8,0,1,0,4,0,0,0,1,840,7,1087
1930,Gangnam,투표소,SS1,삼성1동제1투,"강남구도시관리공단(강남노인종합복지관)(지하1층,식당)",서울특별시 강남구 삼성로 628(삼성동),3245,1622,299,1271,10,19,3,0,0,7,1,1,0,3,1614,8,1623
1931,Gangnam,투표소,SS1,삼성1동제2투,"봉은중학교(1층, 협력종합예술실)",서울특별시 강남구 영동대로128길 59(삼성동),2422,1310,162,1121,2,9,2,3,0,2,5,0,0,1,1307,3,1112
1932,Gangnam,투표소,SS1,삼성1동제3투,"삼성1동문화센터(삼성1동주민센터 1층, 탁구실)",서울특별시 강남구 봉은사로 616(삼성동),3165,1577,312,1226,5,16,3,2,0,4,0,0,0,4,1572,5,1588
1933,Gangnam,투표소,SS2,삼성2동제1투,"삼성2동문화센터(삼성2동주민센터 3층, 회의실)",서울특별시 강남구 봉은사로 419(삼성동),4136,1507,413,1026,7,21,1,0,0,12,7,0,2,8,1497,10,2629
1934,Gangnam,투표소,SS2,삼성2동제2투,"강남구청 제2별관(지하1층, 아카데미교육장)",서울특별시 강남구 학동로 426(삼성동),4059,2320,422,1855,7,11,1,1,0,10,2,0,0,5,2314,6,1739
1935,Gangnam,투표소,SS2,삼성2동제3투,"언주중학교 서관(1층, 교직원식당)",서울특별시 강남구 선릉로116길 57(삼성동),4603,2178,386,1736,11,17,1,3,1,8,2,1,0,6,2172,6,2425
1936,Gangnam,투표소,SS2,삼성2동제4투,"봉전경로당(1층, 할머니방)",서울특별시 강남구 봉은사로68길 39-3(삼성동),3460,1558,417,1075,10,20,2,2,0,11,3,0,0,6,1546,12,1902
1937,Gangnam,투표소,SS2,삼성2동제5투,"강남구청 본관(지하1층, 구내식당)",서울특별시 강남구 학동로 426(삼성동),3339,2027,283,1708,4,9,0,2,0,8,2,0,0,3,2019,8,1312
1938,Gangnam,투표소,DCH1,대치1동제1투,"단대부고(1층, 체육관)",서울특별시 강남구 도곡로64길 21(대치동),3414,2203,197,1966,2,8,2,2,0,12,1,0,1,4,2195,8,1211
1939,Gangnam,투표소,DCH1,대치1동제2투,"단대부중(1층, 다목적실)",서울특별시 강남구 도곡로64길 21(대치동),2544,1502,229,1237,6,12,1,1,0,2,0,0,1,4,1493,9,1042
1940,Gangnam,투표소,DCH1,대치1동제3투,"대치초등학교(1층, 체육관)",서울특별시 강남구 양재천로 363(대치동),2042,1337,130,1183,5,6,0,1,0,3,0,1,0,6,1335,2,705
1941,Gangnam,투표소,DCH1,대치1동제4투,"대청중학교(1층, 급식실)",서울특별시 강남구 양재천로 321(대치동),2204,1446,151,1276,4,4,1,2,0,1,0,0,0,2,1441,5,758
1942,Gangnam,투표소,DCH1,대치1동제5투,"래미안대치팰리스 생활지원센터(1층, 연회장)",서울특별시 강남구 삼성로51길 37(대치동),3414,2144,265,1851,6,10,0,2,0,1,0,0,0,1,2136,8,1270
1943,Gangnam,투표소,DCH2,대치2동제1투,"대치평생학습관(2층, 문화교실)",서울특별시 강남구 영동대로57길 7(대치동),3373,1997,319,1632,3,14,2,5,0,8,1,0,0,3,1987,10,1376
1944,Gangnam,투표소,DCH2,대치2동제2투,"은마아파트 관리동(1층, 경로당)","서울특별시 강남구 삼성로 212(대치동, 은마아파트)",2658,1612,292,1273,5,11,1,7,0,6,3,0,0,4,1602,10,1046
1945,Gangnam,투표소,DCH2,대치2동제3투,"강남구민회관(1층, 홍보전시실)",서울특별시 강남구 삼성로 154(대치동),2786,1668,253,1373,5,10,1,0,0,13,0,0,1,9,1665,3,1118
1946,Gangnam,투표소,DCH2,대치2동제4투,"대곡초등학교(1층, 주차장)",서울특별시 강남구 남부순환로 3022(대치동),2518,1783,153,1601,9,6,1,0,0,1,1,1,0,6,1779,4,735
1947,Gangnam,투표소,DCH2,대치2동제5투,"미도아파트 관리동(2층, 경로당)","서울특별시 강남구 삼성로 150(대치동, 한보미도맨션)",2625,1859,193,1637,3,4,1,2,1,7,2,0,1,3,1854,5,766
1948,Gangnam,투표소,DCH2,대치2동제6투,쌍용주차장 (1층 하나은행 뒤편),서울특별시 강남구 영동대로50길 10(대치동 62-12),3107,2153,278,1829,7,11,1,1,0,4,1,0,1,7,2140,13,954
1949,Gangnam,투표소,DCH2,대치2동제7투,"대치2동주민센터(1층, 회의실)",서울특별시 강남구 영동대로65길 24(대치동),2981,1444,245,1161,4,5,0,4,0,3,1,1,0,12,1436,8,1537
1950,Gangnam,투표소,DCH2,대치2동제8투,"휘문고등학교(1층, 글로벌홀)",서울특별시 강남구 역삼로 541(대치동),2804,1212,311,855,8,17,0,2,1,7,1,0,0,3,1205,7,1592
1951,Gangnam,투표소,DCH4,대치4동제1투,"대치4동문화센터(1층, 어린이교실)",서울특별시 강남구 도곡로77길 23(대치동),3432,1383,399,915,7,17,1,4,1,19,3,0,0,7,1373,10,2049
1952,Gangnam,투표소,DCH4,대치4동제2투,"도곡초등학교 꿈누리관(2층, 식당)",서울특별시 강남구 선릉로64길 33(대치동),3692,1682,514,1105,9,20,1,7,0,6,2,0,0,3,1667,15,2010
1953,Gangnam,투표소,DCH4,대치4동제3투,"대치4동문화센터(대치4동주민센터 5층, 다목적홀)",서울특별시 강남구 도곡로77길 23(대치동),3317,1323,277,998,1,15,0,3,0,14,1,1,0,4,1314,9,1994
1954,Gangnam,투표소,DCH4,대치4동제4투,"도곡초등학교 꿈누리관(3층, 체육관)",서울특별시 강남구 선릉로64길 33(대치동),3639,1236,346,842,5,7,0,6,0,7,2,0,0,9,1224,12,2403
1955,Gangnam,투표소,YS1,역삼1동제1투,"충현복지관(1층, 주차장)",서울특별시 강남구 논현로98길 16(역삼동),3707,1173,338,788,1,16,1,7,0,10,1,0,1,5,1168,5,2534
1956,Gangnam,투표소,YS1,역삼1동제2투,"국립어린이청소년도서관(1층, 주차장)",서울특별시 강남구 테헤란로7길 21(역삼동),3145,1006,287,678,4,15,0,1,0,11,2,2,0,3,1003,3,2139
1957,Gangnam,투표소,YS1,역삼1동제3투,"서울상록회관(1층, 주차장)",서울특별시 강남구 언주로 508(역삼동),3703,1179,390,737,5,13,1,2,0,8,1,0,1,8,1166,13,2524
1958,Gangnam,투표소,YS1,역삼1동제4투,"강남시니어플라자 (2층, 식당)",서울특별시 강남구 봉은사로 332(역삼동),4145,1452,384,1020,5,18,2,2,0,6,1,0,1,3,1442,10,2693
1959,Gangnam,투표소,YS1,역삼1동제5투,"역삼1문화센터(역삼1동주민센터 3층, 회의실)",서울특별시 강남구 역삼로7길 16(역삼동),4734,1306,368,869,7,24,0,3,0,18,3,0,0,5,1297,9,3428
1960,Gangnam,투표소,YS1,역삼1동제6투,"역삼1문화센터(역삼1동주민센터 1층, 전시실)",서울특별시 강남구 역삼로7길 16(역삼동),3446,1244,366,822,5,16,1,4,0,11,2,1,0,4,1232,12,2202
1961,Gangnam,투표소,YS1,역삼1동제7투,"역삼초등학교(1층, 도서관)",서울특별시 강남구 강남대로66길 21(역삼동),5327,1978,476,1398,12,26,5,6,0,21,5,3,0,8,1960,18,3349
1962,Gangnam,투표소,YS2,역삼2동제1투,"역삼2동주민센터(4층, 강당)",서울특별시 강남구 도곡로43길 25(역삼동),3805,1885,346,1494,5,10,1,2,0,9,1,0,1,7,1876,9,1920
1963,Gangnam,투표소,YS2,역삼2동제2투,"진선여자고등학교(1층, 로비)",서울특별시 강남구 선릉로85길 27(역삼동),3682,2052,362,1645,7,12,2,1,0,7,3,0,0,3,2042,10,1630
1964,Gangnam,투표소,YS2,역삼2동제3투,"여성기업종합지원센터(1층, 강의실)",서울특별시 강남구 역삼로 221(역삼동),4588,1632,445,1122,14,15,4,4,0,13,1,0,0,3,1621,11,2956
1965,Gangnam,투표소,YS2,역삼2동제4투,"역삼청소년수련관(1층, 누리터)",서울특별시 강남구 논현로64길 7(역삼동),3834,1609,504,1031,13,19,1,7,0,18,2,0,2,6,1603,6,2225
1966,Gangnam,투표소,YS2,역삼2동제5투,"역삼중학교(1층, 행복교실)",서울특별시 강남구 도곡로43길 10(역삼동),3181,1569,362,1168,5,9,1,2,0,5,3,0,0,7,1562,7,1612
1967,Gangnam,투표소,YS2,역삼2동제6투,"도성초등학교 후관동(1층, 과학실)",서울특별시 강남구 역삼로 313(역삼동),3629,2198,321,1843,6,13,1,2,0,2,0,1,0,5,2194,4,1431
1968,Gangnam,투표소,DK1,도곡1동제1투,"도곡중학교(1층, 미술실)",서울특별시 강남구 언주로57길 31(도곡동),1517,940,155,765,3,6,0,0,0,6,1,0,0,0,936,4,577
1969,Gangnam,투표소,DK1,도곡1동제2투,"도곡정보문화도서관(2층, 도곡1동주민센터)",서울특별시 강남구 도곡로18길 57(도곡1동),3289,1826,325,1459,5,13,1,2,0,6,6,0,0,1,1818,8,1463
1970,Gangnam,투표소,DK1,도곡1동제3투,"도곡정보문화도서관(지하1층, 강당)",서울특별시 강남구 도곡로18길 57(도곡동),3041,1777,370,1370,8,5,2,2,0,10,2,0,0,5,1774,3,1264
1971,Gangnam,투표소,DK1,도곡1동제4투,"언주초등학교(1층, 로비)",서울특별시 강남구 남부순환로363길 19(도곡동),3602,1646,454,1126,9,11,1,5,0,14,6,1,2,4,1633,13,1956
1972,Gangnam,투표소,DK1,도곡1동제5투,매봉산실내배드민턴장(1층),서울특별시 강남구 남부순환로 2711(도곡동),2055,1213,175,1009,3,10,1,1,0,3,2,0,0,2,1206,7,842
1973,Gangnam,투표소,DK2,도곡2동제1투,"도곡2동주민센터(4층, 오유아트홀)",서울특별시 강남구 남부순환로378길 34-9(도곡동),2082,924,187,696,6,16,0,0,0,11,2,0,1,1,920,4,1158
1974,Gangnam,투표소,DK2,도곡2동제2투,"대치중학교(1층, 다목적실)",서울특별시 강남구 남부순환로378길 39(도곡동),2727,1594,201,1358,6,8,4,0,0,7,1,0,0,6,1591,3,1133
1975,Gangnam,투표소,DK2,도곡2동제3투,"타워팰리스1차 C동(1층, 주민회의실)","서울특별시 강남구 언주로30길 56(도곡동, 타워팰리스)",2700,1821,112,1700,0,2,1,0,0,2,0,0,0,3,1820,1,879
1976,Gangnam,투표소,DK2,도곡2동제4투,"타워팰리스1차 B동(1층, 주민회의실)","서울특별시 강남구 언주로30길 56(도곡동, 타워팰리스)",3730,2565,182,2350,6,3,0,0,0,7,2,0,0,5,2555,10,1165
1977,Gangnam,투표소,DK2,도곡2동제5투,"숙명여고 교육정보관(1층, 복도)",서울특별시 강남구 남부순환로 2807(도곡동),3382,2037,243,1745,9,11,3,2,0,8,2,1,0,5,2029,8,1345
1978,Gangnam,투표소,DK2,도곡2동제6투,"도곡렉슬아파트 302동(1층, 컨퍼런스홀)","서울특별시 강남구 선릉로 221(도곡동, 도곡렉슬아파트)",3680,2386,312,2033,6,12,0,2,0,9,1,1,0,4,2380,6,1294
1979,Gangnam,투표소,DK2,도곡2동제7투,"도곡렉슬아파트 209동(1층, 갤러리앤이벤트홀)","서울특별시 강남구 선릉로 221(도곡동, 도곡렉슬아파트)",3389,2141,357,1741,6,7,2,4,0,8,1,0,0,7,2133,8,1248
1980,Gangnam,투표소,KP1,개포1동제1투,"개포1동주민센터(2층, 회의실)","서울특별시 강남구 개포로 303(개포동, 현대1차상가)",1918,1013,111,889,1,3,0,2,0,5,0,0,0,2,1013,0,905
1981,Gangnam,투표소,KP1,개포1동제2투,"구룡중학교 본관(1층, 시청각실)",서울특별시 강남구 선릉로 103(개포동),1331,918,96,806,2,9,1,0,0,1,0,1,0,0,916,2,413
1982,Gangnam,투표소,KP1,개포1동제3투,구룡마을 주민지원실(1층),서울특별시 강남구 양재대로 478(개포동),993,543,249,275,1,7,0,2,2,1,0,0,0,0,537,6,450
1983,Gangnam,투표소,KP2,개포2동제1투,"개포2동주민센터(지하1층, 다목적공연장)",서울특별시 강남구 개포로 511(개포동),3095,1690,288,1356,7,10,0,2,0,8,5,0,1,4,1681,9,1405
1984,Gangnam,투표소,KP2,개포2동제2투,"개포주공5단지관리사무소(1층, 사무실)","서울특별시 강남구 삼성로4길 17(개포동, 주공아파트)",2477,1583,284,1258,6,12,1,4,0,4,1,0,1,2,1573,10,894
1985,Gangnam,투표소,KP2,개포2동제3투,"디에이치아너힐스 클럽컬리넌(지하2층, 실내체육관)","서울특별시 강남구 삼성로 11(개포동, 디에이치 아너힐즈)",2573,1782,272,1473,3,9,1,5,0,8,1,0,0,1,1773,9,791
1986,Gangnam,투표소,KP2,개포2동제4투,"래미안블레스티지 컬쳐센터(1층, 멀티룸)","서울특별시 강남구 선릉로 8(개포동, 래미안블레스티지)",3642,2375,384,1957,3,12,1,1,0,8,1,0,0,2,2369,6,1267
1987,Gangnam,투표소,KP2,개포2동제5투,"개일초등학교(1층, 제1과학실)",서울특별시 강남구 개포로 401(개포동),2320,1274,242,997,7,6,1,0,0,8,3,2,0,3,1269,5,1046
1988,Gangnam,투표소,KP4,개포4동제1투,"개포4동주민센터(1층, 주차장)",서울특별시 강남구 개포로38길 12(개포동),3948,1690,597,1027,11,16,1,4,0,14,2,0,0,7,1679,11,2258
1989,Gangnam,투표소,KP4,개포4동제2투,"구룡초등학교(1층, 회의실)",서울특별시 강남구 개포로 263(개포동),3699,2269,273,1957,6,10,0,1,0,6,1,0,0,2,2256,13,1430
1990,Gangnam,투표소,KP4,개포4동제3투,"포이초등학교 포이교육문화관(1층, 로비)",서울특별시 강남구 개포로22길 87(개포동),3934,1954,515,1387,7,16,1,0,0,11,1,1,0,4,1943,11,1980
1991,Gangnam,투표소,KP4,개포4동제4투,포이경로당(1층),서울특별시 강남구 개포로20길 48(개포동),3793,1771,625,1067,10,26,3,1,0,11,2,1,0,5,1751,20,2022
1992,Gangnam,투표소,IWB,일원본동제1투,"대왕중학교(체육관1층, 로비)",서울특별시 강남구 광평로20길 7(수서동),3851,1953,425,1472,7,17,4,3,0,5,1,1,0,5,1940,13,1898
1993,Gangnam,투표소,IWB,일원본동제2투,"로봇고등학교(로봇관2층, 강당)",서울특별시 강남구 광평로20길 63(일원동),2962,1738,420,1261,12,13,4,5,1,4,2,2,0,8,1732,6,1224
1994,Gangnam,투표소,IWB,일원본동제3투,"중산고등학교(체육관1층, 교직원식당)",서울특별시 강남구 일원로14길 22(일원동),3837,2249,500,1695,10,15,1,4,0,9,2,2,0,4,2242,7,1588
1995,Gangnam,투표소,IWB,일원본동제4투,"왕북초등학교(미래관3층, 강당)",서울특별시 강남구 광평로31길 74(수서동),2910,1409,394,963,7,12,0,2,0,9,3,0,0,6,1396,13,1501
1996,Gangnam,투표소,IW1,일원1동제1투,"일원1동 주민센터(3층, 강당)",서울특별시 강남구 양재대로55길 14(일원동),2343,1075,333,700,5,10,1,3,0,2,1,0,0,8,1063,12,1268
1997,Gangnam,투표소,IW1,일원1동제2투,"일원청소년독서실(1층, 꿈꾸는교실)",서울특별시 강남구 개포로116길 21(일원동),2102,1068,330,700,2,8,1,3,0,8,2,0,1,3,1058,10,1034
1998,Gangnam,투표소,IW1,일원1동제3투,"대청초등학교(1층, 세미나실)",서울특별시 강남구 양재대로55길 28(일원동),2003,946,269,621,7,20,1,2,0,8,2,2,1,1,934,12,1057
1999,Gangnam,투표소,IW1,일원1동제4투,"영희초등학교(2층, 평생교육실)",서울특별시 강남구 일원로 21(일원동),2146,1048,310,688,5,15,0,0,1,11,6,0,1,3,1040,8,1098
2000,Gangnam,투표소,IW1,일원1동제5투,"SH공사관리사무소(1층, 회의실)","서울특별시 강남구 양재대로55길 10(일원동, 수서1단지 에스에이치빌)",1947,918,322,558,4,15,1,0,0,4,2,1,0,3,910,8,1029
2001,Gangnam,투표소,IW2,일원2동제1투,"일원2동주민센터(3층, 강당)",서울특별시 강남구 개포로 607(개포동),1986,961,383,530,7,16,2,0,0,1,4,1,2,5,951,10,1025
2002,Gangnam,투표소,IW2,일원2동제2투,"강남종합사회복지관(2층, 강당)",서울특별시 강남구 개포로109길 5(개포동),2473,1238,318,892,3,8,0,0,0,5,1,0,0,5,1232,6,1235
2003,Gangnam,투표소,IW2,일원2동제3투,대진초등학교 생활관(1층),서울특별시 강남구 개포로109길 74(개포동),2463,1316,302,973,3,13,0,0,0,9,2,1,0,6,1309,7,1147
2004,Gangnam,투표소,IW2,일원2동제4투,"건강가정지원센터(3층, 가족비전홀)",서울특별시 강남구 개포로 617-8(개포동),1712,1043,180,834,4,9,0,1,0,5,4,1,0,2,1040,3,669
2005,Gangnam,투표소,IW2,일원2동제5투,"중동중학교 백주년기념관(1층, 로비)",서울특별시 강남구 일원로8길 37(일원동),2454,1498,279,1182,2,12,1,2,0,5,2,1,1,3,1490,8,956
2006,Gangnam,투표소,SUS,수서동제1투,"수서동주민센터(2층, 회의실)",서울특별시 강남구 광평로 301-4(수서동),2202,1151,222,900,5,9,1,4,0,2,1,0,0,1,1145,6,1051
2007,Gangnam,투표소,SUS,수서동제2투,"수서명화종합사회복지관(1층, 경로식당)","서울특별시 강남구 광평로51길 49(수서동, 수서주공아파트)",1573,807,315,460,1,13,1,1,1,2,0,1,0,3,798,9,766
2008,Gangnam,투표소,SUS,수서동제3투,"강남세움복지관(1층, 식당)",서울특별시 강남구 광평로60길 22(수서동),1805,831,324,474,5,8,1,0,0,2,1,0,0,2,817,14,974
2009,Gangnam,투표소,SUS,수서동제4투,"세종고등학교 본관동(1층, 체육관)",서울특별시 강남구 광평로51길 36(수서동),1770,860,332,508,0,9,1,4,0,1,0,0,0,0,855,5,910
2010,Gangnam,투표소,SUS,수서동제5투,"신동아아파트 관리동 앞(1층, 배드민턴장)","서울특별시 강남구 광평로47길 17(수서동, 신동아아파트)",3156,1838,448,1329,5,11,2,3,0,16,1,2,1,7,1825,13,1318
2011,Gangnam,투표소,SK,세곡동제1투,"세곡동주민센터(1층, 회의실)",서울특별시 강남구 밤고개로 286(율현동),2908,1208,400,765,8,12,1,2,0,10,1,0,0,1,1200,8,1700
2012,Gangnam,투표소,SK,세곡동제2투,"대왕초등학교(1층, 체육관)",서울특별시 강남구 헌릉로618길 8(세곡동),2751,1434,467,919,6,14,2,4,0,9,1,0,0,6,1428,6,1317
2013,Gangnam,투표소,SK,세곡동제3투,"세곡리엔파크 4단지 주민문화센터(1층, 경로당)","서울특별시 강남구 헌릉로590길 88(세곡동, 세곡리엔파크4단지)",3280,1791,643,1097,9,12,1,3,0,9,2,1,0,4,1781,10,1489
2014,Gangnam,투표소,SK,세곡동제4투,"세명초등학교(4층, 체육관)",서울특별시 강남구 자곡로 55(세곡동),3585,1742,542,1158,8,8,1,3,0,7,5,0,0,1,1733,9,1843
2015,Gangnam,투표소,SK,세곡동제5투,한양수자인아파트 경로당(1층),서울특별시 강남구 자곡로 260(자곡동),2704,1658,596,999,14,14,3,6,0,9,2,1,0,4,1648,10,1046
2016,Gangnam,투표소,SK,세곡동제6투,"율현초등학교(3층, 체육관)",서울특별시 강남구 밤고개로21길 15(자곡동),3356,1602,639,902,15,15,0,3,0,11,4,0,0,2,1591,11,1754
2017,Gangnam,투표소,SK,세곡동제7투,"자곡초등학교(3층, 강당)",서울특별시 강남구 자곡로 150(자곡동),3195,1489,473,959,4,17,2,8,0,10,1,1,0,4,1479,10,1706
2018,Gangnam,투표소,SK,세곡동제8투,"세곡중학교(1층, 111호)",서울특별시 강남구 자곡로 81(자곡동),3763,1969,830,1078,7,21,0,5,1,7,4,2,0,3,1958,11,1794
2019,Gangnam,투표소,SK,세곡동제9투,"세곡중학교(2층, 204호)",서울특별시 강남구 자곡로 81(자곡동),2831,1672,429,1194,7,15,0,2,0,10,3,0,0,3,1663,9,1159
2020,Songpa,투표소,PN1,풍납1동제1투,"풍납1동주민센터 (지층, 다목적방)",서울특별시 송파구 천호대로152길 7(풍납동),3550,1371,465,836,7,26,0,5,2,7,3,0,0,8,1359,12,2179
2021,Songpa,투표소,PN1,풍납1동제2투,"서울풍납초등학교(1층, 한울채)",서울특별시 송파구 풍성로 43(풍납동),2676,1078,366,669,7,10,1,2,0,6,4,0,0,7,1072,6,1598
2022,Songpa,투표소,PN1,풍납1동제3투,"솔바람복지센터 (1층, 체육실)",서울특별시 송파구 풍성로5길 16(풍납동),2967,1434,476,894,5,20,1,1,1,20,5,0,1,3,1427,7,1533
2023,Songpa,투표소,PN2,풍납2동제1투,"풍납종합사회복지관(지하1층, 강당)",서울특별시 송파구 강동대로3길 5(풍납동),2867,1156,398,703,7,16,3,2,0,10,2,0,0,6,1147,9,1711
2024,Songpa,투표소,PN2,풍납2동제2투,"풍납2동주민센터 (지하1층, 다목적방)",서울특별시 송파구 토성로 52(풍납동),3238,1535,462,1024,3,16,4,2,0,11,1,0,0,6,1529,6,1703
2025,Songpa,투표소,PN2,풍납2동제3투,"영파여자고등학교 (1층, 보건교육실)",서울특별시 송파구 올림픽로 565(풍납동),2585,1198,339,805,12,11,3,4,0,9,3,0,1,3,1190,8,1387
2026,Songpa,투표소,PN2,풍납2동제4투,"토성초등학교(2층, 체육관)",서울특별시 송파구 풍성로20길 44(풍납동),2803,1306,460,793,3,17,3,3,0,6,4,0,1,3,1293,13,1497
2027,Songpa,투표소,PN2,풍납2동제5투,"도란도란 백제쉼터(2층, 강당)",서울특별시 송파구 풍성로 28(풍납동),2033,1007,332,645,3,14,1,1,0,5,0,0,0,2,1003,4,1026
2028,Songpa,투표소,PN2,풍납2동제6투,"토성초등학교(2층, 체육관)",서울특별시 송파구 풍성로20길 44(풍납동),2632,1183,367,767,8,12,0,1,0,14,1,0,1,3,1174,9,1449
2029,Songpa,투표소,KY1,거여1동제1투,"거여1동주민센터(2층, 회의실)",서울특별시 송파구 오금로53길 32(거여동),3209,1424,517,844,7,28,1,1,0,7,1,1,0,2,1409,15,1785
2030,Songpa,투표소,KY1,거여1동제2투,"서울영풍초등학교(1층, 다목적실)",서울특별시 송파구 오금로57길 15(거여동),2671,1110,401,658,7,19,0,3,0,10,3,1,2,1,1105,5,1561
2031,Songpa,투표소,KY1,거여1동제3투,"송파공업고등학교 (1층, 회의실)",서울특별시 송파구 양산로 21(거여동),2759,1426,444,925,5,17,3,1,0,12,4,0,0,6,1417,9,1333
2032,Songpa,투표소,KY2,거여2동제1투,"거여2동주민센터(3층, 강당)",서울특별시 송파구 거마로2길 19(거여동),3870,1685,505,1128,6,24,0,0,0,8,2,0,0,2,1675,10,2185
2033,Songpa,투표소,KY2,거여2동제2투,"신아원(1층, 작업A실)",서울특별시 송파구 양산로8길 17(거여동),2373,1024,352,564,5,21,7,4,3,11,2,0,3,13,985,39,1349
2034,Songpa,투표소,KY2,거여2동제3투,"거여2단지아파트 관리사무소 (1층, 회의실)",서울특별시 송파구 양산로8길 24(거여동),3307,1791,617,1118,4,16,1,2,0,11,4,1,0,5,1779,12,1516
2035,Songpa,투표소,KY2,거여2동제4투,"거원초등학교(본관 1층, 음악실)",서울특별시 송파구 양산로2길 26(거여동),2837,1413,562,797,5,20,2,2,0,8,2,1,0,4,1403,10,1424
2036,Songpa,투표소,MCH1,마천1동제1투,"마천1동주민센터(지하1층, 탁구장)",서울특별시 송파구 마천로 303(마천동),2451,1005,345,625,4,14,2,1,0,5,2,0,1,4,1003,2,1446
2037,Songpa,투표소,MCH1,마천1동제2투,"마천초등학교 (1층, 과학실)",서울특별시 송파구 마천로61다길 24(마천동),2698,1075,444,600,4,9,1,3,0,2,2,1,1,2,1069,6,1623
2038,Songpa,투표소,MCH1,마천1동제3투,"마천종합사회복지관 (지하1층, 강당)",서울특별시 송파구 마천로65길 4(마천동),2688,1071,402,616,6,22,2,1,0,5,1,1,1,5,1062,9,1617
2039,Songpa,투표소,MCH1,마천1동제4투,"마천초등학교 (1층, 1-1반)",서울특별시 송파구 마천로61다길 24(마천동),2289,907,317,547,6,18,1,2,0,4,2,0,0,1,898,9,1382
2040,Songpa,투표소,MCH1,마천1동제5투,송파파크데일 2단지아파트 경로당(1층),서울특별시 송파구 성내천로47길 38(마천동),3427,1798,725,995,16,19,3,5,0,13,4,2,1,4,1787,11,1629
2041,Songpa,투표소,MCH2,마천2동제1투,"마천2동주민센터(2층, 강의실)",서울특별시 송파구 마천로 287(마천동),3458,1244,484,713,4,14,0,2,0,8,4,1,0,2,1232,12,2214
2042,Songpa,투표소,MCH2,마천2동제2투,"서울남천초등학교(1층, 중앙현관 로비)",서울특별시 송파구 성내천로 207(마천동),3237,1298,476,775,4,20,1,6,0,0,4,0,3,3,1292,6,1939
2043,Songpa,투표소,MCH2,마천2동제3투,"송파구 평생학습원(2층, 강의실)",서울특별시 송파구 마천로35길 12(마천동) 송파구 평생학습원,4044,1891,782,1038,7,19,0,4,1,13,4,0,1,8,1877,14,2153
2044,Songpa,투표소,MCH2,마천2동제4투,"서울남천초등학교 (서관 1층, 자람터)",서울특별시 송파구 성내천로 207(마천동),3113,1440,597,778,7,25,0,3,0,7,4,1,0,3,1425,15,1673
2045,Songpa,투표소,BI1,방이1동제1투,"방이1동주민센터 (2층, 행복누리방)",서울특별시 송파구 위례성대로16길 22(방이동),3425,1705,524,1109,5,23,2,3,0,17,4,1,0,3,1691,14,1720
2046,Songpa,투표소,BI1,방이1동제2투,"방이초등학교(오름관2층, 체육관)",서울특별시 송파구 위례성대로10길 4(방이동),3719,1640,613,953,16,19,1,2,0,13,3,0,1,7,1628,12,2079
2047,Songpa,투표소,BI1,방이1동제3투,"방산중학교(1층, 꿈누리관)",서울특별시 송파구 오금로29길 31(방이동),2974,1609,407,1137,12,8,2,4,0,10,3,1,1,9,1594,15,1365
2048,Songpa,투표소,BI2,방이2동제1투,"방이2동주민센터(2층, 회의실)","서울특별시 송파구 올림픽로34길 5-13(잠실벨솔레, 방이동)",5706,2088,686,1277,12,41,6,5,0,32,5,0,0,5,2069,19,3618
2049,Songpa,투표소,BI2,방이2동제2투,"방이중학교(2층, 해오름관)",서울특별시 송파구 오금로11길 64(방이동),3333,1294,461,748,7,32,2,6,0,16,9,0,0,6,1287,7,2039
2050,Songpa,투표소,BI2,방이2동제3투,"방이중학교(2층, 해오름관)",서울특별시 송파구 오금로11길 64(방이동),3423,1245,446,743,5,19,3,1,0,13,1,0,0,5,1236,9,2178
2051,Songpa,투표소,BI2,방이2동제4투,"방이경로당 (1층, 할머니방)",서울특별시 송파구 가락로39길 11(방이동),3476,1717,636,993,9,17,3,4,0,21,5,1,0,4,1693,24,1759
2052,Songpa,투표소,BI2,방이2동제5투,"방이경로당 (2층, 할아버지방)",서울특별시 송파구 가락로39길 11(방이동),3418,1434,556,807,5,24,1,3,0,18,0,1,0,3,1418,16,1984
2053,Songpa,투표소,OR,오륜동제1투,"오륜동주민센터 (2층, 다목적실)",서울특별시 송파구 양재대로 1232(방이동),2134,1323,224,1075,2,7,3,0,0,3,1,0,0,2,1317,6,811
2054,Songpa,투표소,OR,오륜동제2투,"오륜초등학교 (1층, 시청각실)",서울특별시 송파구 양재대로 1196(방이동),2827,1737,316,1387,4,8,1,6,0,7,2,1,0,4,1736,1,1090
2055,Songpa,투표소,OR,오륜동제3투,"올림픽아파트 제1단지 경로당 (1층, 거실)",서울특별시 송파구 양재대로 1218(방이동),2719,1719,346,1335,5,13,2,3,0,4,1,0,0,2,1711,8,1000
2056,Songpa,투표소,OR,오륜동제4투,"세륜초등학교 (1층, 세륜관)",서울특별시 송파구 양재대로 1264(방이동),2715,1601,263,1297,5,7,2,3,0,5,2,1,0,5,1590,11,1114
2057,Songpa,투표소,OK,오금동제1투,"오금동주민센터 (2층, 주민사랑방)",서울특별시 송파구 중대로25길 5(오금동),3347,1730,298,1388,7,4,4,2,0,8,2,0,0,4,1717,13,1617
2058,Songpa,투표소,OK,오금동제2투,"오금초등학교 (1층, 도서정보실)",서울특별시 송파구 위례성대로22길 11(오금동),3416,1820,489,1264,12,10,3,3,0,10,3,2,0,10,1806,14,1596
2059,Songpa,투표소,OK,오금동제3투,"세륜중학교 (1층, 도서실)",서울특별시 송파구 양재대로72길 41(오금동),3052,1485,518,897,15,19,4,3,0,12,1,0,1,4,1474,11,1567
2060,Songpa,투표소,OK,오금동제4투,"거여초등학교 (1층, 현관로비)",서울특별시 송파구 마천로25길 18(오금동),3938,1899,622,1194,12,29,1,3,0,10,6,1,2,5,1885,14,2039
2061,Songpa,투표소,OK,오금동제5투,"오주중학교 꿈누리관 (1층, 제2음악실)",서울특별시 송파구 동남로 281(오금동),3213,1484,584,840,6,24,1,4,1,11,0,1,0,3,1475,9,1729
2062,Songpa,투표소,OK,오금동제6투,"보인중학교(1층, 다목적교과교실)",서울특별시 송파구 오금로49길 18(오금동),2776,1546,436,1056,4,12,5,3,1,9,1,0,0,7,1534,12,1230
2063,Songpa,투표소,OK,오금동제7투,"개롱초등학교 (1층, 체육관)",서울특별시 송파구 문정로 211(오금동),3851,1819,657,1082,9,21,2,7,0,17,2,3,1,6,1807,12,2032
2064,Songpa,투표소,OK,오금동제8투,"송파레미니스1단지아파트(1층, 경로당)","서울특별시 송파구 성내천로 6(오금동, 송파레미니스)",2906,1477,642,779,7,16,0,7,0,9,2,0,1,3,1466,11,1429
2065,Songpa,투표소,SP1,송파1동제1투,"송파1동주민센터(3층, 다목적회의실)",서울특별시 송파구 백제고분로 392(송파동),3320,1313,487,744,11,22,3,1,0,18,8,1,0,3,1298,15,2007
2066,Songpa,투표소,SP1,송파1동제2투,"송파호수경로당(1층, 할아버지방)",서울특별시 송파구 송파대로48길 28(송파동),2620,1346,433,855,5,15,4,3,0,8,4,0,0,10,1337,9,1274
2067,Songpa,투표소,SP1,송파1동제3투,"송파여성문화회관(1층, 미디어2실)",서울특별시 송파구 백제고분로42길 5(송파동),2335,948,321,579,12,7,1,1,0,9,2,0,0,3,935,13,1387
2068,Songpa,투표소,SP1,송파1동제4투,"송파초등학교(1층, 영어교실)",서울특별시 송파구 백제고분로 400(송파동),2662,1088,373,651,14,18,0,6,0,12,5,0,1,1,1081,7,1574
2069,Songpa,투표소,SP1,송파1동제5투,"송파초등학교(1층, 과학2실)",서울특별시 송파구 백제고분로 400(송파동),3207,1323,482,761,12,21,4,3,0,16,5,0,0,6,1310,13,1884
2070,Songpa,투표소,SP1,송파1동제6투,"송파초등학교(1층, 직원식당)",서울특별시 송파구 백제고분로 400(송파동),3120,1506,440,1004,11,14,1,4,0,12,5,1,0,4,1496,10,1614
2071,Songpa,투표소,SP2,송파2동제1투,"송파2동주민센터 (지하1층, 헬스장)",서울특별시 송파구 송이로 32(송파동),2717,1360,380,940,4,8,2,3,1,9,2,0,0,3,1352,8,1357
2072,Songpa,투표소,SP2,송파2동제2투,"중대초교 내 강동송파특수교육지원센터 (1층, 연수실)",서울특별시 송파구 송파대로36길 8(송파동),2762,1230,438,730,11,19,2,4,1,6,4,0,1,9,1225,5,1532
2073,Songpa,투표소,SP2,송파2동제3투,"가락중학교 (1층, 별관02호)",서울특별시 송파구 송이로 45(송파동),3187,1822,469,1291,7,13,1,4,1,11,3,2,0,7,1809,13,1365
2074,Songpa,투표소,SP2,송파2동제4투,"송파삼성래미안아파트(1층, 경로당)","서울특별시 송파구 오금로32길 14(송파동, 송파삼성래미안아파트)",3614,2085,516,1496,11,20,4,4,0,8,2,0,1,6,2068,17,1529
2075,Songpa,투표소,SCH,석촌동제1투,"석촌동주민센터 (3층, 주민사랑방)",서울특별시 송파구 백제고분로37길 16(석촌동),3384,1316,467,779,16,13,2,2,0,13,5,2,1,7,1307,9,2068
2076,Songpa,투표소,SCH,석촌동제2투,"석촌초등학교 (1층, 보건교육실(별관))",서울특별시 송파구 가락로11길 26(석촌동),3018,1145,454,634,9,12,1,3,0,12,1,0,0,7,1133,12,1873
2077,Songpa,투표소,SCH,석촌동제3투,"석촌초등학교 (1층, 체육관 Performance Zone교실)",서울특별시 송파구 가락로11길 26(석촌동),3601,1361,517,774,11,16,2,7,0,10,2,0,2,7,1348,13,2240
2078,Songpa,투표소,SCH,석촌동제4투,"돌마리경로당 (1층, 할아버지방)",서울특별시 송파구 가락로7길 4(석촌동),3397,1402,534,807,7,16,2,5,0,9,4,1,1,2,1388,14,1995
2079,Songpa,투표소,SCH,석촌동제5투,"석촌초등학교 (1층, 체육관 English Class교실)",서울특별시 송파구 가락로11길 26(석촌동),3286,1283,480,744,5,17,3,1,0,15,5,1,1,3,1275,8,2003
2080,Songpa,투표소,SCH,석촌동제6투,"석촌경로당 (1층, 할아버지방)",서울특별시 송파구 백제고분로40길 13-16(석촌동),3272,1414,527,812,10,28,1,7,0,10,5,0,0,1,1401,13,1858
2081,Songpa,투표소,SCH,석촌동제7투,"석촌동주민센터 (4층, 다목적실)",서울특별시 송파구 백제고분로37길 16(석촌동),2748,1148,389,698,9,19,1,1,0,12,4,2,1,3,1139,9,1600
2082,Songpa,투표소,SJ,삼전동제1투,"삼전동주민센터 (2층, 열람실)",서울특별시 송파구 백제고분로 236(삼전동),2899,1025,399,570,2,19,2,4,0,10,4,0,0,2,1012,13,1874
2083,Songpa,투표소,SJ,삼전동제2투,"송파구민회관 (2층, 소강당)",서울특별시 송파구 백제고분로 242(삼전동),3230,1184,453,680,9,10,1,2,0,13,2,0,0,4,1174,10,2046
2084,Songpa,투표소,SJ,삼전동제3투,"서울시각장애인복지관 (지하1층, 프로그램실)",서울특별시 송파구 삼학사로19길 27(삼전동),3205,1333,506,768,7,21,3,6,0,6,0,1,1,0,1319,14,1872
2085,Songpa,투표소,SJ,삼전동제4투,"송파구민회관 (1층, 로비)",서울특별시 송파구 백제고분로 242(삼전동),2986,1260,450,758,7,18,2,0,0,8,4,0,0,1,1248,12,1726
2086,Songpa,투표소,SJ,삼전동제5투,"송파노인종합복지관 (1층, 식당)",서울특별시 송파구 백제고분로32길 41(삼전동),3531,1584,660,857,6,20,2,2,1,14,3,0,0,9,1574,10,1947
2087,Songpa,투표소,SJ,삼전동제6투,"삼전초등학교 (1층, 회의실)",서울특별시 송파구 백제고분로28길 19(삼전동),3409,1291,495,715,15,16,2,3,0,17,2,1,0,9,1275,16,2118
2088,Songpa,투표소,SJ,삼전동제7투,"삼전초등학교 (1층, 소강당)",서울특별시 송파구 백제고분로28길 19(삼전동),2992,1173,462,666,6,12,4,2,0,9,0,0,1,4,1166,7,1819
2089,Songpa,투표소,KRB,가락본동제1투,"가락본동주민센터 (2층, 다목적실)",서울특별시 송파구 송파대로28길 39(가락동),3021,1127,327,750,1,16,1,5,0,9,4,1,1,2,1117,10,1894
2090,Songpa,투표소,KRB,가락본동제2투,"석촌중학교 (1층, 체육관)",서울특별시 송파구 송이로15길 13(가락동),3567,1725,543,1103,7,29,1,3,0,16,2,0,0,3,1707,18,1842
2091,Songpa,투표소,KRB,가락본동제3투,"석촌중학교 (1층, 체육관)",서울특별시 송파구 송이로15길 13(가락동),3527,1419,456,900,8,23,3,2,0,9,2,1,0,6,1410,9,2108
2092,Songpa,투표소,KRB,가락본동제4투,"신가초등학교 (2층, 다목적강당)",서울특별시 송파구 송이로 75(가락동),2153,1022,293,693,6,11,1,0,0,6,0,0,1,3,1014,8,1131
2093,Songpa,투표소,KRB,가락본동제5투,"가원중학교 (1층, 체육관)",서울특별시 송파구 중대로10길 40-18(가락동),2965,1404,524,820,4,20,1,3,1,12,1,0,0,8,1394,10,1561
2094,Songpa,투표소,KRB,가락본동제6투,"신가초등학교(2층, 다목적강당)",서울특별시 송파구 송이로 75(가락동),2647,1408,356,1009,5,17,1,1,0,5,1,3,0,3,1401,7,1239
2095,Songpa,투표소,KR1,가락1동제1투,"가락1동주민센터 (3층, 대강당)",서울특별시 송파구 양재대로 925(가락동),3459,1752,373,1320,8,10,0,6,0,10,0,0,0,6,1733,19,1707
2096,Songpa,투표소,KR1,가락1동제2투,"해누리중학교 (1층, 3-3반 교실)",서울특별시 송파구 송파대로37길 95(가락동) 해누리중학교,3467,1821,398,1369,7,13,2,2,1,9,0,0,1,6,1808,13,1646
2097,Songpa,투표소,KR1,가락1동제3투,"서울해누리초등학교 (1층, 영어실)",서울특별시 송파구 송파대로37길 95(가락동),2567,1486,308,1151,0,7,2,2,0,6,1,1,1,4,1483,3,1081
2098,Songpa,투표소,KR1,가락1동제4투,"송파책박물관 (1층, 키즈스튜디오)",서울특별시 송파구 송파대로37길 77(가락동),3242,1828,404,1387,7,11,0,4,0,5,1,0,0,1,1820,8,1414
2099,Songpa,투표소,KR1,가락1동제5투,"서울가락초등학교 (1층, 영어전용교실)",서울특별시 송파구 송파대로37길 45(가락동),2875,1551,371,1145,4,12,1,3,0,5,3,0,0,2,1546,5,1324
2100,Songpa,투표소,KR2,가락2동제1투,"가락2동주민센터 (2층, 다목적실)",서울특별시 송파구 중대로20길 6(가락동),3213,1451,512,884,2,21,1,2,1,6,6,1,0,4,1440,11,1762
2101,Songpa,투표소,KR2,가락2동제2투,"가주초등학교 (2층, 체육관)",서울특별시 송파구 오금로40길 37(가락동),2865,1236,429,753,6,14,0,3,0,9,1,2,1,2,1220,16,1629
2102,Songpa,투표소,KR2,가락2동제3투,"쌍용아파트관리사무소(1층, 북카페·경로당)",서울특별시 송파구 동남로 193(가락동),3387,2091,677,1351,7,21,1,4,0,12,4,0,0,2,2079,12,1296
2103,Songpa,투표소,KR2,가락2동제4투,"가동초등학교(2층, 문화관)",서울특별시 송파구 중대로20길 47(가락동),2750,1482,408,1031,5,10,2,3,0,6,2,0,0,5,1472,10,1268
2104,Songpa,투표소,KR2,가락2동제5투,"송파중학교(1층, 어울관 독서실)",서울특별시 송파구 동남로 203(가락동),3014,1590,386,1143,12,14,2,1,1,12,3,0,1,7,1582,8,1424
2105,Songpa,투표소,KR2,가락2동제6투,"극동아파트 (1층, 경로당)",서울특별시 송파구 동남로18길 9(가락동),3019,1646,490,1116,11,5,2,2,0,10,1,0,0,3,1640,6,1373
2106,Songpa,투표소,KR2,가락2동제7투,"삼환아파트 (1층, 경로당)",서울특별시 송파구 오금로 432(가락동 176),2990,1684,516,1099,5,19,2,5,0,20,3,0,0,10,1679,5,1306
2107,Songpa,투표소,MJ1,문정1동제1투,"문정1동주민센터(3층, 다목적실)",서울특별시 송파구 동남로 116(문정동),3919,1530,572,893,9,20,2,2,0,10,3,1,1,6,1519,11,2389
2108,Songpa,투표소,MJ1,문정1동제2투,"문정초등학교(1층, 시청각실)",서울특별시 송파구 문정로5길 20(문정동),2786,1457,444,976,9,14,0,3,0,3,1,0,0,1,1451,6,1329
2109,Songpa,투표소,MJ1,문정1동제3투,"문정중학교 교육정보관동(1층, 멀티미디어실)",서울특별시 송파구 문정로 73(문정동),3533,1345,466,808,9,24,1,5,0,14,5,2,0,2,1336,9,2188
2110,Songpa,투표소,MJ1,문정1동제4투,"문정래미안아파트 관리동(2층, 경로당)",서울특별시 송파구 문정로 83(문정동),3575,2305,463,1790,7,15,2,3,0,10,3,0,0,3,2296,9,1270
2111,Songpa,투표소,MJ2,문정2동제1투,"송파청소년센터 (1층, 로비)",서울특별시 송파구 중대로4길 4(문정동),2490,1635,203,1405,3,7,2,1,0,3,1,1,0,4,1630,5,855
2112,Songpa,투표소,MJ2,문정2동제2투,"올림픽훼밀리타운 관리사무소 (1층, 입주자대표회의실)",서울특별시 송파구 중대로 24(문정동),3302,2062,343,1683,3,8,2,3,0,11,0,0,0,6,2059,3,1240
2113,Songpa,투표소,MJ2,문정2동제3투,"서울가원초등학교(1층, 인성배움터실)",서울특별시 송파구 중대로4길 8(문정동),3012,1865,294,1534,2,8,2,2,0,8,1,0,0,4,1855,10,1147
2114,Songpa,투표소,MJ2,문정2동제4투,"송파푸르지오시티(지하1층, A출입구 로비)",서울특별시 송파구 새말로 62(문정동),4169,1677,643,951,12,12,1,4,0,30,4,1,0,8,1666,11,2492
2115,Songpa,투표소,MJ2,문정2동제5투,"송파파크하비오푸르지오오피스텔 북카페 (202동 2층, 관리사무소앞)",서울특별시 송파구 송파대로 111(문정동),3971,1651,562,1010,9,20,6,2,0,16,6,1,0,9,1641,10,2320
2116,Songpa,투표소,MJ2,문정2동제6투,"호텔 파크하비오 (1층, 로비)","서울특별시 송파구 송파대로 111(문정동, 파크하비오)",4230,2089,599,1401,8,19,4,8,0,23,2,0,0,11,2075,14,2141
2117,Songpa,투표소,JJ,장지동제1투,"장지동주민센터(1층, 주민사랑방)",서울특별시 송파구 새말로19길 6(문정동),1865,792,319,447,1,9,0,3,0,3,1,0,0,6,789,3,1073
2118,Songpa,투표소,JJ,장지동제2투,"문정고등학교(1층, 지락관 드림존)",서울특별시 송파구 송이로34길 62(문정동),2385,1081,319,705,6,20,2,4,0,8,2,0,2,5,1073,8,1304
2119,Songpa,투표소,JJ,장지동제3투,"문덕초등학교(1층, 소회의실)",서울특별시 송파구 송이로34길 60(문정동),3441,1514,600,848,6,19,3,4,0,16,3,1,1,6,1507,7,1927
2120,Songpa,투표소,JJ,장지동제4투,"문정시영아파트 상가(2층, 경로당 할머니방)",서울특별시 송파구 송이로31길 52(문정동),2021,1042,388,619,4,14,0,5,0,4,0,0,0,2,1036,6,979
2121,Songpa,투표소,JJ,장지동제5투,"문현중학교(2층, 느티관)",서울특별시 송파구 충민로 99(장지동),3548,1705,607,1037,3,21,1,2,0,13,5,0,0,4,1693,12,1843
2122,Songpa,투표소,JJ,장지동제6투,"문현고등학교(2층, 체육관)",서울특별시 송파구 충민로 115(장지동),3312,1728,652,1002,9,17,2,4,0,14,6,0,0,3,1709,19,1584
2123,Songpa,투표소,JJ,장지동제7투,"문현초등학교(1층, 1-1반)",서울특별시 송파구 충민로 137(장지동),2918,1584,596,930,9,17,0,3,0,10,6,0,1,1,1573,11,1334
2124,Songpa,투표소,JSB,잠실본동제1투,"잠실본동주민센터 (2층, 다목적실)",서울특별시 송파구 백제고분로15길 9(잠실동),3718,1318,455,809,6,14,3,3,0,11,2,0,0,4,1307,11,2400
2125,Songpa,투표소,JSB,잠실본동제2투,"잠전초등학교 (1층, 중앙현관)",서울특별시 송파구 올림픽로12길 51(잠실동),3257,1160,364,752,8,8,4,1,0,13,1,0,0,2,1153,7,2097
2126,Songpa,투표소,JSB,잠실본동제3투,"잠전초등학교 (1층, 다목적실)",서울특별시 송파구 올림픽로12길 51(잠실동),3187,1228,445,715,13,10,2,1,0,14,2,0,0,8,1210,18,1959
2127,Songpa,투표소,JSB,잠실본동제4투,"잠전초등학교 (1층, 체육관)",서울특별시 송파구 올림픽로12길 51(잠실동),3273,1418,460,879,9,18,2,5,0,19,5,1,0,8,1406,12,1855
2128,Songpa,투표소,JSB,잠실본동제5투,"잠전초등학교 (1층, 체육관)",서울특별시 송파구 올림픽로12길 51(잠실동),3120,1354,437,852,5,14,3,3,0,15,3,1,1,9,1343,11,1766
2129,Songpa,투표소,JSB,잠실본동제6투,"잠전초등학교 (1층, 체육관)",서울특별시 송파구 올림픽로12길 51(잠실동),3561,1412,502,839,14,21,2,4,0,11,1,1,0,6,1401,11,2149
2130,Songpa,투표소,JS2,잠실2동제1투,"잠실2동주민센터 (2층, 주민사랑방 1)",서울특별시 송파구 올림픽로 159(잠실동),2290,1357,295,1029,13,7,0,2,0,3,0,0,0,4,1353,4,933
2131,Songpa,투표소,JS2,잠실2동제2투,"잠신중학교 (1층, 미술1실)",서울특별시 송파구 잠실로 12(잠실동),3128,1814,414,1361,4,10,2,3,0,6,0,1,0,3,1804,10,1314
2132,Songpa,투표소,JS2,잠실2동제3투,"잠신초등학교 (1층, 현관로비)",서울특별시 송파구 잠실로 32(잠실동),3069,1561,344,1177,8,10,1,2,2,3,2,1,0,5,1555,6,1508
2133,Songpa,투표소,JS2,잠실2동제4투,"잠신고등학교 (1층, 삼정관 음악실(2))",서울특별시 송파구 잠실로 24(잠실동),2892,1675,308,1308,8,12,1,7,0,10,3,0,0,3,1660,15,1217
2134,Songpa,투표소,JS2,잠실2동제5투,"잠일초등학교 (3층, 체육관)",서울특별시 송파구 올림픽로 95(잠실동),3156,1786,358,1381,7,11,0,3,0,7,1,0,0,4,1772,14,1370
2135,Songpa,투표소,JS2,잠실2동제6투,"잠일초등학교 (3층, 체육관)",서울특별시 송파구 올림픽로 95(잠실동),2795,1746,388,1317,8,8,2,2,1,5,3,0,1,4,1739,7,1049
2136,Songpa,투표소,JS2,잠실2동제7투,"신천중학교 (1층, 음악실)",서울특별시 송파구 백제고분로 11(잠실동),3120,1879,397,1445,12,11,1,2,0,5,0,0,0,2,1875,4,1241
2137,Songpa,투표소,JS3,잠실3동제1투,"잠실3동주민센터 (2층, 다목적방)",서울특별시 송파구 잠실로 51-31(잠실동),2229,1352,267,1045,8,6,2,2,0,6,2,0,0,4,1342,10,877
2138,Songpa,투표소,JS3,잠실3동제2투,"신천초등학교 (1층, 제2과학실험실)",서울특별시 송파구 올림픽로 215(잠실동),2828,1562,258,1258,9,8,2,5,0,6,0,1,0,5,1552,10,1266
2139,Songpa,투표소,JS3,잠실3동제3투,잠실5단지 경로당 (1층),서울특별시 송파구 송파대로 567(잠실동),2289,1482,272,1171,6,16,0,0,0,2,0,0,1,4,1472,10,807
2140,Songpa,투표소,JS3,잠실3동제4투,"갤러리아팰리스 A동 (1층, 연회실)",서울특별시 송파구 올림픽로 212(잠실동),1993,1302,165,1119,0,8,2,1,0,4,0,0,0,1,1300,2,691
2141,Songpa,투표소,JS3,잠실3동제5투,"송전초등학교 (1층, 2-1반)",서울특별시 송파구 석촌호수로 159(잠실동),3031,1907,348,1515,3,12,1,1,0,12,4,1,0,3,1900,7,1124
2142,Songpa,투표소,JS3,잠실3동제6투,"레이크팰리스 생활지원센터 (1층, 경로당)",서울특별시 송파구 잠실로 88(잠실동),2350,1573,298,1241,6,6,1,3,0,6,2,0,0,3,1566,7,777
2143,Songpa,투표소,JS3,잠실3동제7투,"버들초등학교 (1층, 로비)",서울특별시 송파구 석촌호수로 81(잠실동),3433,2083,420,1626,9,8,0,3,0,7,2,0,0,2,2077,6,1350
2144,Songpa,투표소,JS3,잠실3동제8투,"트리지움 생활지원센터 (1층, 경로당)",서울특별시 송파구 잠실로 62(잠실동),3532,2255,501,1701,2,14,2,3,0,11,1,0,0,5,2240,15,1277
2145,Songpa,투표소,JS4,잠실4동제1투,"잠실4동주민센터 (3층, 다목적실)",서울특별시 송파구 올림픽로35길 16(신천동),2552,1362,277,1058,3,7,1,2,0,5,2,1,0,0,1356,6,1190
2146,Songpa,투표소,JS4,잠실4동제2투,"잠실초등학교 (1층 해오름관, 1학년 국화반)",서울특별시 송파구 올림픽로35길 20(신천동),3081,1817,361,1419,3,14,0,2,0,4,2,0,0,4,1809,8,1264
2147,Songpa,투표소,JS4,잠실4동제3투,"잠실고등학교 (1층, 탁구장)",서울특별시 송파구 올림픽로33길 71(신천동),3154,1846,377,1424,5,9,2,5,0,6,2,1,0,4,1835,11,1308
2148,Songpa,투표소,JS4,잠실4동제4투,"잠현초등학교 (1층, 1-2반 1실)",서울특별시 송파구 올림픽로37길 109(신천동),3289,1895,428,1419,7,9,0,1,0,18,3,0,0,2,1887,8,1394
2149,Songpa,투표소,JS6,잠실6동제1투,"잠실6동주민센터 (1층, 생활체육교실)",서울특별시 송파구 올림픽로35길 120(신천동),3525,1839,342,1445,10,10,4,5,2,5,4,1,1,4,1833,6,1686
2150,Songpa,투표소,JS6,잠실6동제2투,"잠동초등학교 (1층, 대강당)",서울특별시 송파구 올림픽로35길 122(신천동),3262,1842,329,1465,5,10,4,1,0,11,1,1,1,7,1835,7,1420
2151,Songpa,투표소,JS6,잠실6동제3투,"장미아파트 경로당(1층, 충효노인정)",서울특별시 송파구 올림픽로35길 104(신천동),3138,1878,332,1495,10,10,3,2,0,6,1,3,0,8,1870,8,1260
2152,Songpa,투표소,JS7,잠실7동제1투,"송파문화원(1층, 강당)",서울특별시 송파구 올림픽로 44(잠실동),3079,1943,199,1702,3,6,1,4,0,8,3,0,1,6,1933,10,1136
2153,Songpa,투표소,JS7,잠실7동제2투,"우성아파트 경로당 (1층, 할머니방)",서울특별시 송파구 올림픽로4길 42(잠실동),2938,1901,323,1532,4,9,4,2,0,9,2,0,1,5,1891,10,1037
2154,Songpa,투표소,WR,위례동제1투,"위례동 주민센터 (3층, 다목적실)",서울특별시 송파구 위례광장로 210(장지동),3275,1679,380,1260,3,11,0,3,0,8,1,0,0,4,1670,9,1596
2155,Songpa,투표소,WR,위례동제2투,"송례초등학교 (1층, 초록반)",서울특별시 송파구 위례순환로 439(장지동),3583,1857,699,1095,4,17,0,7,1,9,6,3,0,8,1849,8,1726
2156,Songpa,투표소,WR,위례동제3투,"송례중학교(1층, B동104 공용1)",서울특별시 송파구 위례순환로 429(장지동),3365,1559,541,973,3,12,1,7,0,9,5,0,1,2,1554,5,1806
2157,Songpa,투표소,WR,위례동제4투,"위례별초등학교 (후관동 1층, 2학년 해교실)",서울특별시 송파구 위례광장로 243(장지동),3329,1150,396,717,6,12,1,0,0,2,3,1,0,4,1142,8,2179
2158,Songpa,투표소,WR,위례동제5투,"위례포레샤인아파트 2313동 (1층, 다목적실)","서울특별시 송파구 위례순환로 477(장지동, 위례포레샤인23단지)",3308,1844,828,945,7,23,1,3,0,12,7,0,1,5,1832,12,1464
2159,Gangdong,투표소,KI,강일동제1투,"강일동주민센터(3층, 대강당)",서울특별시 강동구 아리수로93길 9-14(강일동),3181,1348,503,799,8,18,0,3,0,4,3,0,0,3,1341,7,1833
2160,Gangdong,투표소,KI,강일동제2투,"강동중학교 전관(1층, 체육실)",서울특별시 강동구 풍산로 237(강일동),2693,1295,531,718,8,14,1,3,0,6,2,1,0,4,1288,7,1398
2161,Gangdong,투표소,KI,강일동제3투,"강일초등학교(1층, 1-2반)",서울특별시 강동구 아리수로98길 24(강일동),2653,1363,510,802,10,14,0,3,0,5,2,1,0,5,1352,11,1290
2162,Gangdong,투표소,KI,강일동제4투,"강일고등학교(창조관 1층, 교직원 식당)",서울특별시 강동구 아리수로98길 40(강일동),2931,1366,560,754,4,16,1,3,0,11,6,0,0,2,1357,9,1565
2163,Gangdong,투표소,KI,강일동제5투,"고덕리엔파크1단지 106동(1층, 주민공동시설)","서울특별시 강동구 상일로 152(강일동, 고덕리엔파크1단지아파트)",2651,1497,685,736,8,18,2,6,1,20,6,0,2,1,1485,12,1154
2164,Gangdong,투표소,KI,강일동제6투,"강명중학교(1층, 통합교과교실)",서울특별시 강동구 상일로12길 56(강일동),2120,1105,475,591,6,18,0,1,0,6,1,0,1,3,1102,3,1015
2165,Gangdong,투표소,KI,강일동제7투,"강명중학교(1층, 제2과학실)",서울특별시 강동구 상일로12길 56(강일동),2624,1436,626,754,4,16,1,3,0,12,0,1,0,4,1421,15,1188
2166,Gangdong,투표소,KI,강일동제8투,"강동리버스트 4단지 409동 (1층, 경로당)","서울특별시 강동구 아리수로93가길 110(강일동, 강동리버스트4단지)",2332,1259,578,628,13,20,1,9,1,1,1,0,0,2,1254,5,1073
2167,Gangdong,투표소,KI,강일동제9투,"강동리버스트 7단지 702동(1층, 공유주방)","서울특별시 강동구 아리수로93가길 70(강일동, 강동리버스트7단지)",3032,1579,716,808,4,22,0,1,0,7,4,2,0,5,1569,10,1453
2168,Gangdong,투표소,KI,강일동제10투,"강동리엔파크 9단지(1층, 작은도서관)","서울특별시 강동구 고덕로98길 29901동 1층 작은도서관 (강일동, 강동리엔파크9단지)",935,541,228,284,4,13,1,0,0,6,1,1,0,2,540,1,394
2169,Gangdong,투표소,SI1,상일동제1투,"상일동주민센터(2층, 회의실)",서울특별시 강동구 구천면로 633(상일동),1875,980,325,630,3,6,2,1,0,4,0,0,0,0,971,9,895
2170,Gangdong,투표소,SI1,상일동제2투,"상일초등학교(1층, 과학실)",서울특별시 강동구 천호대로 1477(상일동),2129,971,318,607,4,17,0,4,0,10,0,0,0,3,963,8,1158
2171,Gangdong,투표소,SI1,상일동제3투,"전우용사촌(신생보훈빌라)(1층, 체육관)","서울특별시 강동구 상암로 375-18(상일동, 신생보훈빌라)",2411,1278,326,892,7,21,3,1,0,5,0,1,2,8,1266,12,1133
2172,Gangdong,투표소,SI2,상일동제4투,"고덕센트럴아이파크 515동(1층, 맘스앤키즈라운지)","서울특별시 강동구 고덕로80길 99515동 (상일동, 고덕센트럴아이파크아파트)",3175,1691,523,1127,9,15,0,3,0,4,3,0,0,4,1688,3,1484
2173,Gangdong,투표소,SI2,상일동제5투,"고덕롯데캐슬베네루체 708동(1층, 다목적홀)","서울특별시 강동구 상암로79길 88708동 다목적홀 (상일동, 고덕롯데캐슬베네루체아파트)",3180,1877,545,1289,4,16,2,0,0,5,4,0,0,1,1866,11,1303
2174,Gangdong,투표소,SI2,상일동제6투,"고덕아르테온 311동(1층, 갤러리카페)","서울특별시 강동구 고덕로 360311동 (상일동, 고덕아르테온)",3798,2251,721,1449,8,22,2,6,1,12,6,1,0,8,2236,15,1547
2175,Gangdong,투표소,SI2,상일동제7투,"고덕아르테온 318동(1층,티하우스)","서울특별시 강동구 고덕로 360318동 (상일동, 고덕아르테온)",3506,2085,577,1452,7,15,1,5,0,12,5,0,0,4,2078,7,1421
2176,Gangdong,투표소,SI2,상일동제8투,"고덕자이아파트 경로당(1층,오락실)",서울특별시 강동구 상일로 55(상일동),2110,1329,447,838,8,12,0,5,0,7,2,0,0,4,1323,6,781
2177,Gangdong,투표소,MI1,명일제1동제1투,"강동청소년회관(4층, 대강당)",서울특별시 강동구 양재대로138길 41(명일동),3229,1498,456,994,6,17,3,2,1,5,3,1,0,4,1492,6,1731
2178,Gangdong,투표소,MI1,명일제1동제2투,"강동노인회관(3층, 강당)",서울특별시 강동구 천중로49길 104(명일동),3544,1892,540,1270,9,23,1,1,0,16,1,5,0,8,1874,18,1652
2179,Gangdong,투표소,MI1,명일제1동제3투,"삼익2차아파트(1층, 어르신사랑방)","서울특별시 강동구 고덕로 210(명일동, 삼익그린맨션)",2794,1682,399,1223,6,17,2,2,0,17,0,0,0,9,1675,7,1112
2180,Gangdong,투표소,MI1,명일제1동제4투,"고명초등학교(1층, 회의실)",서울특별시 강동구 고덕로46길 53(명일동),3544,1894,524,1314,4,16,0,4,0,4,2,1,0,5,1874,20,1650
2181,Gangdong,투표소,MI1,명일제1동제5투,"강동평생학습센터(3층, 강당)",서울특별시 강동구 구천면로 395(명일동),3636,1721,557,1094,5,22,3,3,0,12,5,1,0,3,1705,16,1915
2182,Gangdong,투표소,MI2,명일제2동제1투,"주공9단지관리사무소(1층, 어르신사랑방)",서울특별시 강동구 상암로 251(명일동),2462,1540,389,1094,8,15,0,5,0,10,3,0,0,6,1530,10,922
2183,Gangdong,투표소,MI2,명일제2동제2투,"대명초등학교(정보관1층, 현관로비)",서울특별시 강동구 상암로 271(명일동),2580,1266,391,820,4,16,5,3,0,6,1,0,0,4,1250,16,1314
2184,Gangdong,투표소,MI2,명일제2동제3투,"강동노인종합복지관(2층, 북카페)",서울특별시 강동구 동남로71길 32-5(명일동),3073,1795,508,1208,10,12,0,4,0,25,5,2,1,8,1783,12,1278
2185,Gangdong,투표소,MI2,명일제2동제4투,"명원초등학교(체육관1층, 현관로비)",서울특별시 강동구 명일로 364(명일동),2615,1589,347,1183,7,16,3,3,0,11,1,0,1,5,1577,12,1026
2186,Gangdong,투표소,KD1,고덕제1동제1투,"명일중학교(서관1층, 무용실)",서울특별시 강동구 양재대로156길 57(고덕동),2011,923,326,560,6,15,0,9,0,4,1,0,0,1,922,1,1088
2187,Gangdong,투표소,KD1,고덕제1동제2투,"고덕1동주민센터(4층, 강당)",서울특별시 강동구 양재대로156길 123(고덕동),1972,1011,329,648,0,6,1,6,0,6,2,0,0,2,1000,11,961
2188,Gangdong,투표소,KD1,고덕제1동제3투,"고덕1동주민센터(3층, 회의실)",서울특별시 강동구 양재대로156길 123(고덕동),1979,1047,322,689,4,10,0,3,0,6,2,0,0,5,1041,6,932
2189,Gangdong,투표소,KD1,고덕제1동제4투,"묘곡초등학교(신관1층, 시청각실 로비)",서울특별시 강동구 동남로79길 46(고덕동),2121,928,289,596,9,19,1,2,0,3,1,1,0,2,923,5,1193
2190,Gangdong,투표소,KD1,고덕제1동제5투,"래미안힐스테이트고덕 116동(1층, 대연회장)","서울특별시 강동구 아리수로50길 50(고덕동, 래미안힐스테이트고덕)",3056,1866,529,1285,10,12,0,5,1,14,0,0,0,4,1860,6,1190
2191,Gangdong,투표소,KD1,고덕제1동제6투,"래미안힐스테이트고덕 116동(지하1층, 소연회장)","서울특별시 강동구 아리수로50길 50(고덕동, 래미안힐스테이트고덕)",2980,1651,518,1092,6,9,0,6,0,5,3,0,2,2,1643,8,1329
2192,Gangdong,투표소,KD2,고덕제2동제1투,"고덕2동주민센터(2층, 다목적실)",서울특별시 강동구 아리수로78길 43-12(고덕동),2336,974,298,635,3,20,1,2,0,6,1,2,0,1,969,5,1362
2193,Gangdong,투표소,KD2,고덕제2동제2투,"서울고덕초등학교(1층, 시청각실)",서울특별시 강동구 아리수로82길 42(고덕동),3000,1327,413,879,1,13,0,4,1,4,0,0,0,4,1319,8,1673
2194,Gangdong,투표소,KD2,고덕제2동제3투,"고덕그라시움 119동(지하1층, 커뮤니티센터)","서울특별시 강동구 고덕로 333(고덕동, 고덕그라시움)",3559,2089,520,1508,7,18,3,6,0,8,5,0,0,7,2082,7,1470
2195,Gangdong,투표소,KD2,고덕제2동제4투,"고덕그라시움 141동(1층, 연회장)","서울특별시 강동구 고덕로 333(고덕동, 고덕그라시움)",2157,1309,373,897,3,14,2,2,0,5,3,0,1,1,1301,8,848
2196,Gangdong,투표소,KD2,고덕제2동제5투,"고덕그라시움 124동(1층, 시니어클럽)","서울특별시 강동구 고덕로 333(고덕동, 고덕그라시움)",2843,1686,401,1238,3,15,2,1,0,7,1,1,0,5,1674,12,1157
2197,Gangdong,투표소,AS1,암사제1동제1투,"암사1동주민센터(2층, 회의실)",서울특별시 강동구 올림픽로98가길 57(암사동),3563,1373,519,786,12,23,2,0,0,8,4,1,0,2,1357,16,2190
2198,Gangdong,투표소,AS1,암사제1동제2투,"암사1동자치회관(지층, 주차장)",서울특별시 강동구 고덕로24길 49암사1동자치회관 (암사동),3218,1214,510,660,9,18,0,2,0,7,2,0,1,0,1209,5,2004
2199,Gangdong,투표소,AS1,암사제1동제3투,"상상나루래 (지하1층, 다목적실)",서울특별시 강동구 올림픽로98가길 28상상나루래 (암사동),3106,1220,458,713,5,18,1,2,0,7,3,1,0,3,1211,9,1886
2200,Gangdong,투표소,AS1,암사제1동제4투,"암사도서관(지하1층, 해강홀)",서울특별시 강동구 고덕로20길 42(암사동),3036,1282,485,744,10,20,0,1,0,5,3,0,3,4,1275,7,1754
2201,Gangdong,투표소,AS1,암사제1동제5투,새장터어르신사랑방(2층),서울특별시 강동구 암사1가길 16새장터어르신사랑방 (암사동),2582,973,363,558,4,21,0,1,0,9,1,1,2,3,963,10,1609
2202,Gangdong,투표소,AS1,암사제1동제6투,"암사1동자치회관(1층, 다목적실)",서울특별시 강동구 고덕로24길 49(암사동),2812,1075,414,618,8,13,1,3,0,8,3,0,0,1,1069,6,1737
2203,Gangdong,투표소,AS1,암사제1동제7투,"암사1동제1어르신사랑방(1층, 할머니방)",서울특별시 강동구 구천면로59길 19(암사동),2786,1229,426,741,9,24,0,5,0,9,2,1,0,3,1220,9,1557
2204,Gangdong,투표소,AS1,암사제1동제8투,"프라이어팰리스아파트관리사무소(3층, 회의실)",서울특별시 강동구 고덕로 130(암사동),3082,1809,538,1214,10,11,2,3,0,12,6,1,1,5,1803,6,1273
2205,Gangdong,투표소,AS2,암사제2동제1투,"선사초등학교(1층, 중앙현관)",서울특별시 강동구 올림픽로 837(암사동),2225,1019,285,697,4,13,1,3,1,5,3,1,0,3,1016,3,1206
2206,Gangdong,투표소,AS2,암사제2동제2투,"신암초등학교(1층, 교과실)",서울특별시 강동구 올림픽로93길 33-16(암사동),3933,1788,648,1053,9,16,4,1,0,25,6,1,0,11,1774,14,2145
2207,Gangdong,투표소,AS2,암사제2동제3투,"암사2동주민센터(4층, 강당)",서울특별시 강동구 상암로3길 28(암사동),3090,1607,498,1056,6,12,1,11,0,8,1,0,1,2,1596,11,1483
2208,Gangdong,투표소,AS3,암사제3동제1투,"암사3동주민센터(3층, 회의실)",서울특별시 강동구 고덕로 137(암사동),3071,1652,431,1170,11,8,0,5,0,11,3,1,1,6,1647,5,1419
2209,Gangdong,투표소,AS3,암사제3동제2투,"강동롯데캐슬퍼스트아파트 관리동(지하1층, 주민공동시설)",서울특별시 강동구 고덕로 131(암사동),2780,1603,422,1146,2,5,2,4,0,7,1,0,1,7,1597,6,1177
2210,Gangdong,투표소,AS3,암사제3동제3투,"선사고등학교(1층, 다목적실)",서울특별시 강동구 고덕로25길 17(암사동),2671,1371,460,868,11,13,1,0,0,5,1,1,0,1,1361,10,1300
2211,Gangdong,투표소,AS3,암사제3동제4투,"신암중학교(1층, 탁구연습실)",서울특별시 강동구 고덕로 65(암사동),2293,1179,391,745,4,18,2,1,0,11,0,0,1,3,1176,3,1114
2212,Gangdong,투표소,CHH1,천호제1동제1투,"천호제1동주민센터(2층, 회의실)",서울특별시 강동구 구천면로42길 59(천호동),3630,1315,491,768,5,20,1,3,0,7,2,0,0,4,1301,14,2315
2213,Gangdong,투표소,CHH1,천호제1동제2투,"천호중학교(1층, 가사실)",서울특별시 강동구 상암로 153(천호동),3352,1489,506,936,7,15,2,1,0,7,2,1,0,4,1481,8,1863
2214,Gangdong,투표소,CHH1,천호제1동제3투,"천호초등학교(1층, 중앙현관)",서울특별시 강동구 구천면로 310-11(천호동),3172,1223,503,668,7,15,1,3,0,8,4,1,1,2,1213,10,1949
2215,Gangdong,투표소,CHH1,천호제1동제4투,"강동구민회관(2층, 문화관람실)",서울특별시 강동구 상암로 168(천호동),3596,1635,609,965,7,19,1,3,0,11,2,1,1,3,1622,13,1961
2216,Gangdong,투표소,CHH1,천호제1동제5투,"천호마을활력소(지하1층, 다목적실)",서울특별시 강동구 구천면로68나길 17(천호동),2997,1498,515,925,7,22,1,3,1,6,3,2,1,3,1489,9,1499
2217,Gangdong,투표소,CHH1,천호제1동제6투,"천일초등학교(1층, 과학실)",서울특별시 강동구 구천면로 266(천호동),2756,1208,466,686,12,18,0,1,0,6,1,0,1,7,1198,10,1548
2218,Gangdong,투표소,CHH2,천호제2동제1투,"천호2동제1자치회관(1층, 강의실)",서울특별시 강동구 구천면로 141(천호동),2640,1168,442,685,5,20,0,1,1,4,2,0,0,5,1165,3,1472
2219,Gangdong,투표소,CHH2,천호제2동제2투,"신암초등학교(1층, 보건교육실)",서울특별시 강동구 올림픽로93길 33-16(암사동),2957,1298,456,780,7,22,3,1,1,10,2,0,0,4,1286,12,1659
2220,Gangdong,투표소,CHH2,천호제2동제3투,"구립천호2동경로당(1층, 할머니방)",서울특별시 강동구 구천면로13길 21(천호동),2479,1001,373,574,3,21,2,2,1,5,3,4,0,5,993,8,1478
2221,Gangdong,투표소,CHH2,천호제2동제4투,"한국마사회 강동문화공감센터(1층, 지정좌석실)",서울특별시 강동구 구천면로 200(천호동),3173,1216,388,775,6,12,2,5,0,9,5,0,0,5,1207,9,1957
2222,Gangdong,투표소,CHH2,천호제2동제5투,"강동구립해공노인복지관(2층, 해오름관)",서울특별시 강동구 천중로17길 42-16(천호동),3725,1499,589,856,4,20,1,0,0,6,3,0,1,6,1486,13,2226
2223,Gangdong,투표소,CHH2,천호제2동제6투,"강동초등학교(1층, 과학실)",서울특별시 강동구 상암로14길 77(천호동),3646,1471,560,857,6,22,0,2,0,4,4,1,1,4,1461,10,2175
2224,Gangdong,투표소,CHH2,천호제2동제7투,"천일중학교(1층, 다목적실)",서울특별시 강동구 천중로 57(천호동),3798,1434,546,820,13,25,1,1,0,8,1,0,0,3,1418,16,2364
2225,Gangdong,투표소,CHH2,천호제2동제8투,"해공체육문화센터(1층, 체육관)",서울특별시 강동구 천중로18길 61(천호동),2230,879,304,536,1,11,2,3,0,6,5,2,0,3,873,6,1351
2226,Gangdong,투표소,CHH3,천호제3동제1투,"청년해냄센터(2층,까페테리아)",서울특별시 강동구 천호대로 10572층 (천호동),2772,1112,381,678,2,14,0,2,0,13,2,0,1,5,1098,14,1660
2227,Gangdong,투표소,CHH3,천호제3동제2투,"동신중학교(2층, 1학년4반)",서울특별시 강동구 진황도로 72(천호동),3225,1418,386,984,7,12,1,2,2,10,2,0,0,4,1410,8,1807
2228,Gangdong,투표소,CHH3,천호제3동제3투,"동신중학교(2층, 1학년5반)",서울특별시 강동구 진황도로 72(천호동),3609,1550,570,915,11,22,2,2,0,6,2,1,1,7,1539,11,2059
2229,Gangdong,투표소,CHH3,천호제3동제4투,"북까페도서관 다독다독 2호점(1층, 중앙홀)",서울특별시 강동구 구천면로34길 161층 (천호동),3222,1176,437,679,4,23,1,4,0,13,2,1,0,4,1168,8,2046
2230,Gangdong,투표소,CHH3,천호제3동제5투,강동구립천호도서관(2층),서울특별시 강동구 성안로31마길 1(천호동),3308,1287,506,712,15,20,3,6,0,8,4,0,0,4,1278,9,2021
2231,Gangdong,투표소,CHH3,천호제3동제6투,"서울천동초등학교(1층,연수실)",서울특별시 강동구 성안로 200(길동),3083,1396,547,791,7,24,2,4,0,7,2,0,2,1,1387,9,1687
2232,Gangdong,투표소,SN1,성내제1동제1투,"성내1동주민센터(3층, 다목적실)",서울특별시 강동구 성내로 13(성내동),3004,1322,461,800,5,18,0,3,0,14,2,2,0,8,1313,9,1682
2233,Gangdong,투표소,SN1,성내제1동제2투,"강동구의회(1층, 로비)",서울특별시 강동구 성내로 55(성내동),3546,1740,626,1044,6,17,3,6,0,12,7,0,0,2,1723,17,1806
2234,Gangdong,투표소,SN1,성내제1동제3투,"성일초등학교(1층, 장미반)",서울특별시 강동구 성내로15길 33(성내동),3086,1395,584,742,12,16,3,3,0,12,4,1,0,3,1380,15,1691
2235,Gangdong,투표소,SN1,성내제1동제4투,"성내초등학교(1층, 제2과학실)",서울특별시 강동구 성내로3길 19(성내동),3272,1747,528,1159,4,22,1,2,0,8,3,1,0,2,1730,17,1525
2236,Gangdong,투표소,SN2,성내제2동제1투,"성내2동주민센터(지층,강의실)",서울특별시 강동구 풍성로37가길 62(성내동),3331,1188,416,715,11,21,0,3,0,9,1,0,0,4,1180,8,2143
2237,Gangdong,투표소,SN2,성내제2동제2투,"성내종합사회복지관(지층, 강당)",서울특별시 강동구 성안로13길 56성내종합사회복지관 (성내동),3633,1522,546,904,6,24,0,4,0,16,4,0,0,4,1508,14,2111
2238,Gangdong,투표소,SN2,성내제2동제3투,"승룡이네집(1층,까페)",서울특별시 강동구 천호대로168가길 65-29(성내동) 승룡이네집,3656,1478,543,865,5,22,3,4,0,16,4,2,0,1,1465,13,2178
2239,Gangdong,투표소,SN2,성내제2동제4투,"구립웃말경로당(1층,할머니방)",서울특별시 강동구 천호대로162길 72(성내동),3153,1298,495,747,7,10,2,4,0,11,2,1,3,7,1289,9,1855
2240,Gangdong,투표소,SN2,성내제2동제5투,"성내어울터(지층, 다목적실)",서울특별시 강동구 올림픽로62길 35성내어울터 (성내동),3404,1433,529,840,8,20,4,4,0,10,2,0,0,2,1419,14,1971
2241,Gangdong,투표소,SN3,성내제3동제1투,"성내제3동주민센터(2층, 제1강의실)",서울특별시 강동구 강동대로53길 76(성내동),3243,1385,493,842,6,14,5,0,1,5,2,0,0,2,1370,15,1858
2242,Gangdong,투표소,SN3,성내제3동제2투,"호원취업지원센터(1층,로비)",서울특별시 강동구 성안로 30(성내동),3594,1560,516,971,6,24,1,10,1,8,7,0,1,6,1551,9,2034
2243,Gangdong,투표소,SN3,성내제3동제3투,"동아1차아파트(1층, 주민문화교실)",서울특별시 강동구 풍성로54길 12-11(성내동),4407,2044,710,1251,13,18,2,7,0,14,2,0,2,7,2026,18,2363
2244,Gangdong,투표소,SN3,성내제3동제4투,"엔젤공방 허브센터 (지하1층, 다목적실)",서울특별시 강동구 성안로 108(성내동),4526,1958,727,1122,7,33,6,8,0,22,8,2,1,9,1945,13,2568
2245,Gangdong,투표소,K,길동제1투,"길동초등학교 (2층, 실과실)",서울특별시 강동구 양재대로116길 69(길동),3427,1255,452,750,4,20,3,4,1,8,0,2,0,3,1247,8,2172
2246,Gangdong,투표소,K,길동제2투,"길동초등학교(1층, 체육실)",서울특별시 강동구 양재대로116길 69(길동),2838,1323,441,841,6,12,1,0,0,15,2,0,0,2,1320,3,1515
2247,Gangdong,투표소,K,길동제3투,"길동초등학교(1층, 음악실)",서울특별시 강동구 양재대로116길 69(길동),3457,1543,588,900,2,22,1,2,0,9,5,0,0,2,1531,12,1914
2248,Gangdong,투표소,K,길동제4투,"천동초등학교(어울마루2층, 예체능교실)",서울특별시 강동구 성안로 200(길동),4990,1680,620,975,3,23,1,12,0,21,4,0,1,7,1667,13,3310
2249,Gangdong,투표소,K,길동제5투,"천동초등학교(어울마루2층, 음악실)",서울특별시 강동구 성안로 200(길동),2526,1179,451,684,7,15,1,1,0,5,1,3,0,2,1170,9,1347
2250,Gangdong,투표소,K,길동제6투,"신명중학교(1층, 탁구실)",서울특별시 강동구 명일로24길 25(길동),3765,1300,465,781,5,15,2,3,0,8,3,0,0,5,1287,13,2465
2251,Gangdong,투표소,K,길동제7투,"길동주민센터(4층, 대강당)",서울특별시 강동구 천호대로 1183(길동),3328,1552,481,1009,5,18,1,5,1,15,3,0,0,6,1544,8,1776
2252,Gangdong,투표소,K,길동제8투,"신명초등학교(1층, 다목적1실)",서울특별시 강동구 명일로24길 33(길동),1940,1002,339,621,5,19,1,1,1,7,2,0,0,3,999,3,938
2253,Gangdong,투표소,K,길동제9투,"신명중학교(1층, 체력단련실)",서울특별시 강동구 명일로24길 25(길동),2973,1363,415,897,6,18,1,2,0,7,3,1,0,5,1355,8,1610
2254,Gangdong,투표소,K,길동제10투,"길동주민센터(3층, 제1강의실)",서울특별시 강동구 천호대로 1183(길동),3181,1279,450,781,9,18,0,0,0,5,4,1,1,3,1272,7,1902
2255,Gangdong,투표소,DCH2,둔촌제2동제1투,"강동꿈마을(1층, 강당)",서울특별시 강동구 천호대로186길 21(둔촌동),3850,1580,541,960,11,20,1,5,0,18,2,0,2,8,1568,12,2270
2256,Gangdong,투표소,DCH2,둔촌제2동제2투,"한산중학교(1층, 예절실)",서울특별시 강동구 풍성로 251(둔촌동),3545,1633,618,958,8,19,3,2,1,11,4,2,1,1,1628,5,1912
2257,Gangdong,투표소,DCH1,둔촌제2동제3투·둔촌제1동투,"한산초등학교(1층, 영어교실)",서울특별시 강동구 풍성로 261(둔촌동),4033,2145,735,1347,10,20,0,4,0,10,3,2,1,7,2139,6,1888
2258,Gangdong,투표소,DCH1,둔촌제2동제4투,"선린초등학교(1층, 강당)",서울특별시 강동구 진황도로61길 29(둔촌동),2314,1048,326,691,5,8,1,0,1,4,1,0,0,1,1038,10,1266
2259,Gangdong,투표소,DCH1,둔촌제2동제5투,"둔촌푸르지오아파트(1층, 어르신사랑방)","서울특별시 강동구 명일로 172(둔촌동, 둔촌푸르지오아파트)",3347,1835,484,1291,10,14,3,5,0,7,5,0,0,7,1826,9,1512
